저희 안경원 코드 번호 확인이 가능할까요?	매장코드
저희 안경원 코드를 잊어버렸습니다	매장코드
안경원 코드번호 확인이 어렵습니다 어떻게 해야하나요?	매장코드
매장 코드번호 확인이 어렵습니다 어떻게 해야하나요?	매장코드
안경원 코드번호 확인하는 방법이 있을까요?	매장코드
안경원 코드번호 조회부탁드립니다	매장코드
저희 안경원 코드 확인부탁드려요	매장코드
안경원 코드 번호를 잊어버렸어요 확인부탁드려요	매장코드
안경원 코드 번호 확인을 어디에서 확인 할 수 있나요?	매장코드
저희 안경원 코드 어떻게 확인 할 수 있나요?	매장코드
저희 매장 코드 번호 확인하고싶어요	매장코드
매장 코드 번호 어디에서 볼 수 있나요?	매장코드
매장 코드 번호 확인하고싶어요 어디에서 볼 수 있나요?	매장코드
매장 코드 번호 조회는 어디에서 할 수 있나요?	매장코드
매장 코드 번호 어떻게 알 수 있나요?	매장코드
매장 번호 확인하고싶어요 어디에서 볼 수 있나요?	매장코드
코드번호 까먹었습니다	매장코드
코드번호 잊어버렸습니다	매장코드
코드번호 잊어버렸을땐 어떻게 해야하죠?	매장코드
매장 코드 번호 잊어버렸습니다 어떻게 확인하죠?	매장코드
저희 매장 코드 번호 확인 가능할까요?	매장코드
저희 가게 코드 번호 확인 가능할까요?	매장코드
저희 가게 코드번호 확인부탁드립니다	매장코드
저희 가게 코드번호 까먹었어요	매장코드
저희 가게 코드번호 까먹었어요 다시 알려주세요	매장코드
저희 매장 코드번호 까먹었어요 다시 알려주세요	매장코드
저희 안경원 코드번호 까먹었어요 다시 알려주세요	매장코드
저희 매장 코드번호 까먹었는데 다시 알려주세요	매장코드
저희 안경원 코드번호 까먹었는데 다시 알려주세요	매장코드
저희 안경원 코드를 알고자 합니다	매장코드
저희 가게 코드번호 까먹었는데 다시 알려주세요	매장코드
안경원 코드 번호 확인 어떻게 해?	매장코드
안경원 코드 번호 확인 어떻게 해요?	매장코드
안경원 코드 번호 확인 어떻게 하나요?	매장코드
안경원 코드 번호 확인 어떻게 하죠?	매장코드
안경원 코드 번호 확인 어떻게 합니까?	매장코드
안경원 코드 번호 확인 어떻게 할수있죠?	매장코드
안경원 코드 번호 확인 어떻게 확인하죠?	매장코드
안경원 코드 번호 확인 어떻게 알수있죠?	매장코드
안경원 코드 번호 확인 어떻게 확인할수있나요?	매장코드
안경원 코드 번호 확인 어떻게 알수있나요?	매장코드
코드번호문의 어디서 해?	매장코드
코드번호문의 어디서 해요?	매장코드
코드번호문의 어디서 하나요?	매장코드
코드번호문의 어디서 합니까?	매장코드
코드번호문의 어디서 할까요?	매장코드
코드번호문의 어디서 해야하죠?	매장코드
코드번호문의 어디서 해야해?	매장코드
코드번호문의 어디서 해야할까?	매장코드
코드번호문의 어디서 해야하나요?	매장코드
코드번호문의 어디서 해야할까요?	매장코드
코드번호문의 어디서 해야합니까?	매장코드
코드번호문의 어디서 해야되나요?	매장코드
코드번호문의 어디서 하면됩니까?	매장코드
코드번호문의 어디서 할수있습니까?	매장코드
코드번호문의 어디서 할수있는지알려주세요	매장코드
코드번호문의 어디서 할수있는지궁금합니다	매장코드
코드번호조회 어디서 해?	매장코드
코드번호조회 어디서 해요?	매장코드
코드번호조회 어디서 하나요?	매장코드
코드번호조회 어디서 합니까?	매장코드
코드번호조회 어디서 할까요?	매장코드
코드번호조회 어디서 해야하죠?	매장코드
코드번호조회 어디서 해야해?	매장코드
코드번호조회 어디서 해야할까?	매장코드
코드번호조회 어디서 해야하나요?	매장코드
코드번호조회 어디서 해야할까요?	매장코드
코드번호조회 어디서 해야합니까?	매장코드
코드번호조회 어디서 해야되나요?	매장코드
코드번호조회 어디서 하면됩니까?	매장코드
코드번호조회 어디서 할수있습니까?	매장코드
코드번호조회 어디서 할수있는지알려주세요	매장코드
코드번호조회 어디서 할수있는지궁금합니다	매장코드
저희 안경원 코드번호확인이 가능할까요?	매장코드
안경원 코드번호확인이 어렵습니다 어떻게 해야하나요?	매장코드
매장 코드번호확인이 어렵습니다 어떻게 해야하나요?	매장코드
안경원 코드번호확인하는 방법이 있을까요?	매장코드
안경원 코드번호 조회부탁드립니다	매장코드
저희 안경원 코드 확인 부탁드려요	매장코드
안경원 코드 번호를 잊어버렸어요 확인 부탁드려요	매장코드
안경원 코드번호확인을 어디에서 확인할수있나요?	매장코드
저희 안경원 코드 어떻게 확인할수있나요?	매장코드
저희 매장코드번호 확인하고싶어요	매장코드
매장코드번호 어디에서 볼수있나요?	매장코드
매장코드번호 확인하고싶어요 어디에서 볼수있나요?	매장코드
매장코드번호 조회는 어디에서 할수있나요?	매장코드
매장코드번호 어떻게 알수있나요?	매장코드
매장번호 확인하고싶어요 어디에서 볼수있나요?	매장코드
코드 번호 까먹었습니다	매장코드
코드 번호 잊어버렸습니다	매장코드
코드 번호 잊어버렸을땐 어떻게 해야하죠?	매장코드
매장 코드번호 잊어버렸습니다 어떻게 확인하죠?	매장코드
저희 매장 코드번호 확인 가능할까요?	매장코드
저희 가게 코드번호 확인 가능할까요?	매장코드
저희 가게 코드번호 확인부탁드립니다	매장코드
저희 가게 코드번호 까먹었어요	매장코드
저희 가게 코드번호 까먹었어요 다시 알려주세요	매장코드
저희 매장 코드번호 까먹었어요 다시 알려주세요	매장코드
저희 안경원 코드번호 까먹었어요 다시 알려주세요	매장코드
저희 매장 코드번호 까먹었는데 다시 알려주세요	매장코드
저희 안경원 코드번호 까먹었는데 다시 알려주세요	매장코드
저희 가게 코드 번호 까먹었는데 다시 알려주세요	매장코드
안경원 코드번호확인 어떻게 해?	매장코드
안경원 코드번호확인 어떻게 해요?	매장코드
안경원 코드번호확인 어떻게 하나요?	매장코드
안경원 코드번호확인 어떻게 하죠?	매장코드
안경원 코드번호확인 어떻게 합니까?	매장코드
안경원 코드번호확인 어떻게 할수있죠?	매장코드
안경원 코드번호확인 어떻게 확인하죠?	매장코드
안경원 코드번호확인 어떻게 알수있죠?	매장코드
안경원 코드번호확인 어떻게 확인할수있나요?	매장코드
안경원 코드번호확인 어떻게 알수있나요?	매장코드
코드 번호문의 어디서 해?	매장코드
코드 번호문의 어디서 해요?	매장코드
코드 번호문의 어디서 하나요?	매장코드
코드 번호문의 어디서 합니까?	매장코드
코드 번호문의 어디서 할까요?	매장코드
코드 번호문의 어디서 해야하죠?	매장코드
코드 번호문의 어디서 해야해?	매장코드
코드 번호문의 어디서 해야할까?	매장코드
코드 번호문의 어디서 해야하나요?	매장코드
코드 번호문의 어디서 해야할까요?	매장코드
코드 번호문의 어디서 해야합니까?	매장코드
코드 번호문의 어디서 해야되나요?	매장코드
코드 번호문의 어디서 하면됩니까?	매장코드
코드 번호문의 어디서 할수있습니까?	매장코드
코드 번호문의 어디서 할수있는지알려주세요	매장코드
코드 번호문의 어디서 할수있는지궁금합니다	매장코드
코드 번호조회 어디서 해?	매장코드
코드 번호조회 어디서 해요?	매장코드
코드 번호조회 어디서 하나요?	매장코드
코드 번호조회 어디서 합니까?	매장코드
코드 번호조회 어디서 할까요?	매장코드
코드 번호조회 어디서 해야하죠?	매장코드
코드 번호조회 어디서 해야해?	매장코드
코드 번호조회 어디서 해야할까?	매장코드
코드 번호조회 어디서 해야하나요?	매장코드
코드 번호조회 어디서 해야할까요?	매장코드
코드 번호조회 어디서 해야합니까?	매장코드
코드 번호조회 어디서 해야되나요?	매장코드
코드 번호조회 어디서 하면됩니까?	매장코드
코드 번호조회 어디서 할수있습니까?	매장코드
코드 번호조회 어디서 할수있는지알려주세요	매장코드
코드 번호조회 어디서 할수있는지궁금합니다	매장코드
안경원 코드 번호확인 어떻게 해?	매장코드
안경원 코드 번호확인 어떻게 해요?	매장코드
안경원 코드 번호확인 어떻게 하나요?	매장코드
안경원 코드 번호확인 어떻게 하죠?	매장코드
안경원 코드 번호확인 어떻게 합니까?	매장코드
안경원 코드 번호확인 어떻게 할수있죠?	매장코드
안경원 코드 번호확인 어떻게 확인하죠?	매장코드
안경원 코드 번호확인 어떻게 알수있죠?	매장코드
안경원 코드 번호확인 어떻게 확인할수있나요?	매장코드
안경원 코드 번호확인 어떻게 알수있나요?	매장코드
코드 번호 문의 어디서 해?	매장코드
코드 번호 문의 어디서 해요?	매장코드
코드 번호 문의 어디서 하나요?	매장코드
코드 번호 문의 어디서 합니까?	매장코드
코드 번호 문의 어디서 할까요?	매장코드
코드 번호 문의 어디서 해야하죠?	매장코드
코드 번호 문의 어디서 해야해?	매장코드
코드 번호 문의 어디서 해야할까?	매장코드
코드 번호 문의 어디서 해야하나요?	매장코드
코드 번호 문의 어디서 해야할까요?	매장코드
코드 번호 문의 어디서 해야합니까?	매장코드
코드 번호 문의 어디서 해야되나요?	매장코드
코드 번호 문의 어디서 하면됩니까?	매장코드
코드 번호 문의 어디서 할수있습니까?	매장코드
코드 번호 문의 어디서 할수있는지알려주세요	매장코드
코드 번호 문의 어디서 할수있는지궁금합니다	매장코드
코드 번호 조회 어디서 해?	매장코드
코드 번호 조회 어디서 해요?	매장코드
코드 번호 조회 어디서 하나요?	매장코드
코드 번호 조회 어디서 합니까?	매장코드
코드 번호 조회 어디서 할까요?	매장코드
코드 번호 조회 어디서 해야하죠?	매장코드
코드 번호 조회 어디서 해야해?	매장코드
코드 번호 조회 어디서 해야할까?	매장코드
코드 번호 조회 어디서 해야하나요?	매장코드
코드 번호 조회 어디서 해야할까요?	매장코드
코드 번호 조회 어디서 해야합니까?	매장코드
코드 번호 조회 어디서 해야되나요?	매장코드
코드 번호 조회 어디서 하면됩니까?	매장코드
코드 번호 조회 어디서 할수있습니까?	매장코드
코드 번호 조회 어디서 할수있는지알려주세요	매장코드
코드 번호 조회 어디서 할수있는지궁금합니다	매장코드
저희 매장 코드 번호 확인 가능할까요?	매장코드
저희 가게 코드 번호 확인 가능할까요?	매장코드
저희 가게 코드 번호 확인부탁드립니다	매장코드
저희 가게 코드 번호 까먹었어요	매장코드
저희 가게 코드 번호 까먹었어요 다시 알려주세요	매장코드
저희 매장 코드 번호 까먹었어요 다시 알려주세요	매장코드
저희 안경원 코드 번호 까먹었어요 다시 알려주세요	매장코드
저희 매장 코드 번호 까먹었는데 다시 알려주세요	매장코드
저희 안경원 코드 번호 까먹었는데 다시 알려주세요	매장코드
안경원 코드번호확인을 어디에서 확인할 수 있나요?	매장코드
저희 안경원 코드 어떻게 확인할 수 있나요?	매장코드
저희 매장 코드번호 확인하고싶어요	매장코드
매장 코드번호 어디에서 볼수있나요?	매장코드
매장 코드번호 확인하고싶어요 어디에서 볼수있나요?	매장코드
매장 코드번호 조회는 어디에서 할수있나요?	매장코드
매장 코드번호 어떻게 알수있나요?	매장코드
매장 번호 확인하고싶어요 어디에서 볼수있나요?	매장코드
안경원 코드 번호확인이 어렵습니다 어떻게 해야하나요?	매장코드
매장 코드 번호확인이 어렵습니다 어떻게 해야하나요?	매장코드
안경원 코드 번호확인하는 방법이 있을까요?	매장코드
안경원 코드 번호 조회부탁드립니다	매장코드
저희 안경원 코드 번호확인이 가능할까요?	매장코드
저희 안경원 코드번호 확인이 가능할까요?	매장코드
안경원 코드번호 확인이 어렵습니다 어떻게 해야하나요?	매장코드
매장 코드번호 확인이 어렵습니다 어떻게 해야하나요?	매장코드
안경원 코드번호 확인하는 방법이 있을까요?	매장코드
안경원 코드번호  조회부탁드립니다	매장코드
안경원 코드 번호확인을 어디에서 확인할수있나요?	매장코드
저희 매장코드 번호 확인하고싶어요	매장코드
매장코드 번호 어디에서 볼수있나요?	매장코드
매장코드 번호 확인하고싶어요 어디에서 볼수있나요?	매장코드
매장코드 번호 조회는 어디에서 할수있나요?	매장코드
매장코드 번호 어떻게 알수있나요?	매장코드
매장번호 확인하고싶어요 어디에서 볼 수 있나요?	매장코드
저희 매장 코드번호 확인가능할까요?	매장코드
저희 가게 코드번호 확인가능할까요?	매장코드
저희 가게 코드번호 확인 부탁드립니다	매장코드
안경원 코드 번호 확인 어떻게 해?	매장코드
안경원 코드 번호 확인 어떻게 해요?	매장코드
안경원 코드 번호 확인 어떻게 하나요?	매장코드
안경원 코드 번호 확인 어떻게 하죠?	매장코드
안경원 코드 번호 확인 어떻게 합니까?	매장코드
안경원 코드 번호 확인 어떻게 할수있죠?	매장코드
안경원 코드 번호 확인 어떻게 확인하죠?	매장코드
안경원 코드 번호 확인 어떻게 알수있죠?	매장코드
안경원 코드 번호 확인 어떻게 확인할수있나요?	매장코드
안경원 코드 번호 확인 어떻게 알수있나요?	매장코드
코드번호문의 어디서 할 수 있습니까?	매장코드
코드번호문의 어디서 할 수 있는지알려주세요	매장코드
코드번호문의 어디서 할 수 있는지궁금합니다	매장코드
코드번호조회 어디서 할 수 있습니까?	매장코드
코드번호조회 어디서 할 수 있는지알려주세요	매장코드
코드번호조회 어디서 할 수 있는지궁금합니다	매장코드
저희 안경원 코드 번호 확인이 가능할까요?	매장코드
안경원 코드 번호 확인이 어렵습니다 어떻게 해야하나요?	매장코드
매장 코드 번호 확인이 어렵습니다 어떻게 해야하나요?	매장코드
안경원 코드 번호 확인하는 방법이 있을까요?	매장코드
안경원 코드 번호  조회부탁드립니다	매장코드
안경원 코드 번호확인을 어디에서 확인할 수 있나요?	매장코드
안경원 코드 번호 확인을 어디에서 확인할수있나요?	매장코드
안경원 코드 번호 확인을 어디에서 확인할 수 있나요?	매장코드
저희 매장 코드 번호 확인하고싶어요	매장코드
매장 코드 번호 어디에서 볼수있나요?	매장코드
매장 코드 번호 확인하고싶어요 어디에서 볼수있나요?	매장코드
매장 코드 번호 조회는 어디에서 할수있나요?	매장코드
매장 코드 번호 어떻게 알수있나요?	매장코드
매장 번호 확인하고싶어요 어디에서 볼 수 있나요?	매장코드
저희 매장코드 번호 확인하고싶어요	매장코드
매장코드 번호 어디에서 볼 수 있나요?	매장코드
매장코드 번호 확인하고싶어요 어디에서 볼 수 있나요?	매장코드
매장코드 번호 조회는 어디에서 할 수 있나요?	매장코드
매장코드 번호 어떻게 알 수 있나요?	매장코드
저희 매장 코드 번호 확인하고싶어요	매장코드
매장 코드 번호 어디에서 볼 수 있나요?	매장코드
매장 코드 번호 확인하고싶어요 어디에서 볼 수 있나요?	매장코드
매장 코드 번호 조회는 어디에서 할 수 있나요?	매장코드
매장 코드 번호 어떻게 알 수 있나요?	매장코드
저희 매장 코드 번호 확인가능할까요?	매장코드
저희 가게 코드 번호 확인가능할까요?	매장코드
저희 가게 코드 번호 확인 부탁드립니다	매장코드
안경원 코드 번호 확인 어떻게 해?	매장코드
안경원 코드 번호 확인 어떻게 해요?	매장코드
안경원 코드 번호 확인 어떻게 하나요?	매장코드
안경원 코드 번호 확인 어떻게 하죠?	매장코드
안경원 코드 번호 확인 어떻게 합니까?	매장코드
안경원 코드 번호 확인 어떻게 할수있죠?	매장코드
안경원 코드번호확인 어떻게 할 수 있죠?	매장코드
안경원 코드 번호확인 어떻게 할 수 있죠?	매장코드
안경원 코드 번호 확인 어떻게 할 수 있죠?	매장코드
안경원 코드 번호 확인 어떻게 확인하죠?	매장코드
안경원 코드 번호 확인 어떻게 알수있죠?	매장코드
안경원 코드번호확인 어떻게 알 수 있죠?	매장코드
안경원 코드 번호확인 어떻게 알 수 있죠?	매장코드
안경원 코드 번호 확인 어떻게 알 수 있죠?	매장코드
안경원 코드 번호 확인 어떻게 확인할수있나요?	매장코드
안경원 코드번호확인 어떻게 확인할 수 있나요?	매장코드
안경원 코드 번호확인 어떻게 확인할 수 있나요?	매장코드
안경원 코드 번호 확인 어떻게 확인할 수 있나요?	매장코드
안경원 코드 번호 확인 어떻게 알수있나요?	매장코드
안경원 코드번호확인 어떻게 알 수 있나요?	매장코드
안경원 코드 번호확인 어떻게 알 수 있나요?	매장코드
안경원 코드 번호 확인 어떻게 알 수 있나요?	매장코드
코드 번호문의 어디서 할 수 있습니까?	매장코드
코드 번호 문의 어디서 할 수 있습니까?	매장코드
코드 번호문의 어디서 할 수 있는지알려주세요	매장코드
코드 번호 문의 어디서 할 수 있는지알려주세요	매장코드
코드번호문의 어디서 할 수 있는지 알려주세요	매장코드
코드 번호문의 어디서 할 수 있는지 알려주세요	매장코드
코드 번호 문의 어디서 할 수 있는지 알려주세요	매장코드
코드 번호문의 어디서 할 수 있는지궁금합니다	매장코드
코드 번호 문의 어디서 할 수 있는지궁금합니다	매장코드
코드번호문의 어디서 할 수 있는지 궁금합니다	매장코드
코드 번호문의 어디서 할 수 있는지 궁금합니다	매장코드
코드 번호 문의 어디서 할 수 있는지 궁금합니다	매장코드
코드 번호조회 어디서 할 수 있습니까?	매장코드
코드 번호 조회 어디서 할 수 있습니까?	매장코드
코드 번호조회 어디서 할 수 있는지알려주세요	매장코드
코드 번호 조회 어디서 할 수 있는지알려주세요	매장코드
코드번호조회 어디서 할 수 있는지 알려주세요	매장코드
코드 번호조회 어디서 할 수 있는지 알려주세요	매장코드
코드 번호 조회 어디서 할 수 있는지 알려주세요	매장코드
코드 번호조회 어디서 할 수 있는지궁금합니다	매장코드
코드 번호 조회 어디서 할 수 있는지궁금합니다	매장코드
코드번호조회 어디서 할 수 있는지 궁금합니다	매장코드
코드 번호조회 어디서 할 수 있는지 궁금합니다	매장코드
코드 번호 조회 어디서 할 수 있는지 궁금합니다	매장코드
이번달 대금청구서 발송이 가능할까요?	청구금액
대금청구서 좀 발송해주세요	청구금액
대금청구서 받고 싶습니다	청구금액
대금청구서 보내주세요	청구금액
대금청구서 	청구금액
대금청구서 발송부탁드립니다	청구금액
대금청구서 받고싶습니다 확인 후 전송 부탁드립니다	청구금액
이번달 대금청구서 보내주세요	청구금액
이번달 청구내역 보내주세요	청구금액
이번달 청구금액 보내주세요	청구금액
이번달 청구내역 발송해주세요	청구금액
이번달 청구내역 확인하고싶습니다	청구금액
이번달 청구내역 어디에서 확인할 수 있을까요?	청구금액
이번달 청구금액 확인하고싶습니다 어떻게 해야하나요?	청구금액
이번달 청구금액은 어디에서 확인 할 수 있을까요?	청구금액
이번달 청구내역 어디에서 확인 할 수 있는지 궁금합니다	청구금액
이번달 청구금액 알고싶은데 어떻게 확인 할 수 있나요?	청구금액
이번 달 청구금액 발송 부탁드립니다	청구금액
이번 달 청구내역 발송 부탁드립니다	청구금액
이번 달 대금청구서 발송 부탁드립니다	청구금액
이번 달 대금청구서 발송됐나요?	청구금액
이번 달 청구내역 발송됐나요?	청구금액
이번 달 청구서 발송됐나요?	청구금액
대금청구서 어떻게 받을 수 있을까요?	청구금액
어떻게 해야 대금청구서를 받을 수 있을까요?	청구금액
어떻게 해야 대금청구서를 받을 수 있을까?	청구금액
어떻게 해야 대금청구서를 받을 수 있습니까?	청구금액
어떻게 하면 대금청구서를 받을 수 있습니까?	청구금액
어떻게 하면 대금청구서를 받을 수 있어요?	청구금액
어떻게 하면 대금청구서를 받을 수 있을까?	청구금액
어떻게 하면 대금청구서를 받을 수 있을까요?	청구금액
이번달 청구금액 확인 어떻게 해?	청구금액
이번달 청구금액 확인 어떻게 해요?	청구금액
이번달 청구금액 확인 어떻게 하죠?	청구금액
이번달 청구금액 확인 어떻게 할까요?	청구금액
이번달 청구금액 확인 어떻게 하나요?	청구금액
이번달 청구금액 확인 어떻게 합니까?	청구금액
이번달 청구금액 확인 어떻게 해야되죠?	청구금액
이번달 청구금액 확인 어떻게 해야돼죠?	청구금액
이번달 청구금액 확인 어떻게 해야하죠?	청구금액
이번달 청구금액 확인 어떻게 해야할까요?	청구금액
이번달 청구금액 확인 어떻게 해야될까요?	청구금액
이번달 청구금액 확인 어떻게 해야됩니까?	청구금액
이번달 대금청구서 어디서 확인해?	청구금액
이번달 대금청구서 어디서 확인해요?	청구금액
이번달 대금청구서 어디서 확인하죠?	청구금액
이번달 대금청구서 어디서 확인할까요?	청구금액
이번달 대금청구서 어디서 확인하나요?	청구금액
이번달 대금청구서 어디서 확인해야하죠?	청구금액
이번달 대금청구서 어디서 확인해야할까요?	청구금액
이번달 대금청구서 어디서 확인할수있나요?	청구금액
이번달 대금청구서 어디에서 확인해?	청구금액
이번달 대금청구서 어디에서 확인해요?	청구금액
이번달 대금청구서 어디에서 확인하죠?	청구금액
이번달 대금청구서 어디에서 확인할까요?	청구금액
이번달 대금청구서 어디에서 확인하나요?	청구금액
이번달 대금청구서 어디에서 확인해야하죠?	청구금액
이번달 대금청구서 어디에서 확인해야할까요?	청구금액
이번달 대금청구서 어디에서 확인할수있나요?	청구금액
이번달 청구금액 어디에서 확인해?	청구금액
이번달 청구금액 어디에서 확인해요?	청구금액
이번달 청구금액 어디에서 확인하죠?	청구금액
이번달 청구금액 어디에서 확인할까요?	청구금액
이번달 청구금액 어디에서 확인하나요?	청구금액
이번달 청구금액 어디에서 확인해야하죠?	청구금액
이번달 청구금액 어디에서 확인해야할까요?	청구금액
이번달 청구금액 어디에서 확인할수있나요?	청구금액
이번달 청구금액 어디서 확인해?	청구금액
이번달 청구금액 어디서 확인해요?	청구금액
이번달 청구금액 어디서 확인하죠?	청구금액
이번달 청구금액 어디서 확인할까요?	청구금액
이번달 청구금액 어디서 확인하나요?	청구금액
이번달 청구금액 어디서 확인해야하죠?	청구금액
이번달 청구금액 어디서 확인해야할까요?	청구금액
이번달 청구금액 어디서 확인할수있나요?	청구금액
이번 달 대금청구서 보내주세요	청구금액
이번 달 청구내역 보내주세요	청구금액
이번 달 청구금액 보내주세요	청구금액
이번 달 청구내역 발송해주세요	청구금액
이번 달 청구내역 확인하고싶습니다	청구금액
이번 달 청구내역 어디에서 확인할 수 있을까요?	청구금액
이번 달 청구금액 확인하고싶습니다 어떻게 해야하나요?	청구금액
이번 달 청구금액은 어디에서 확인 할 수 있을까요?	청구금액
이번 달 청구내역 어디에서 확인 할 수 있는지 궁금합니다	청구금액
이번 달 청구금액 알고싶은데 어떻게 확인 할 수 있나요?	청구금액
이번달 청구금액 발송 부탁드립니다	청구금액
이번달 청구내역 발송 부탁드립니다	청구금액
이번달 대금청구서 발송 부탁드립니다	청구금액
이번달 대금청구서 발송됐나요?	청구금액
이번달 청구내역 발송됐나요?	청구금액
이번달 청구서 발송됐나요?	청구금액
대금청구서 어떻게 받을수있을까요?	청구금액
어떻게 해야 대금청구서를 받을수있을까요?	청구금액
어떻게 해야 대금청구서를 받을수있을까?	청구금액
어떻게 해야 대금청구서를 받을수있습니까?	청구금액
어떻게 하면 대금청구서를 받을수있습니까?	청구금액
어떻게 하면 대금청구서를 받을수있어요?	청구금액
어떻게 하면 대금청구서를 받을수있을까?	청구금액
어떻게 하면 대금청구서를 받을수있을까요?	청구금액
이번 달 청구금액 확인 어떻게 해?	청구금액
이번 달 청구금액 확인 어떻게 해요?	청구금액
이번 달 청구금액 확인 어떻게 하죠?	청구금액
이번 달 청구금액 확인 어떻게 할까요?	청구금액
이번 달 청구금액 확인 어떻게 하나요?	청구금액
이번 달 청구금액 확인 어떻게 합니까?	청구금액
이번 달 청구금액 확인 어떻게 해야되죠?	청구금액
이번 달 청구금액 확인 어떻게 해야돼죠?	청구금액
이번 달 청구금액 확인 어떻게 해야하죠?	청구금액
이번 달 청구금액 확인 어떻게 해야할까요?	청구금액
이번 달 청구금액 확인 어떻게 해야될까요?	청구금액
이번 달 청구금액 확인 어떻게 해야됩니까?	청구금액
이번 달 대금청구서 어디서 확인해?	청구금액
이번 달 대금청구서 어디서 확인해요?	청구금액
이번 달 대금청구서 어디서 확인하죠?	청구금액
이번 달 대금청구서 어디서 확인할까요?	청구금액
이번 달 대금청구서 어디서 확인하나요?	청구금액
이번 달 대금청구서 어디서 확인해야하죠?	청구금액
이번 달 대금청구서 어디서 확인해야할까요?	청구금액
이번 달 대금청구서 어디서 확인할수있나요?	청구금액
이번 달 대금청구서 어디에서 확인해?	청구금액
이번 달 대금청구서 어디에서 확인해요?	청구금액
이번 달 대금청구서 어디에서 확인하죠?	청구금액
이번 달 대금청구서 어디에서 확인할까요?	청구금액
이번 달 대금청구서 어디에서 확인하나요?	청구금액
이번 달 대금청구서 어디에서 확인해야하죠?	청구금액
이번 달 대금청구서 어디에서 확인해야할까요?	청구금액
이번 달 대금청구서 어디에서 확인할수있나요?	청구금액
이번 달 청구금액 어디에서 확인해?	청구금액
이번 달 청구금액 어디에서 확인해요?	청구금액
이번 달 청구금액 어디에서 확인하죠?	청구금액
이번 달 청구금액 어디에서 확인할까요?	청구금액
이번 달 청구금액 어디에서 확인하나요?	청구금액
이번 달 청구금액 어디에서 확인해야하죠?	청구금액
이번 달 청구금액 어디에서 확인해야할까요?	청구금액
이번 달 청구금액 어디에서 확인할수있나요?	청구금액
이번 달 청구금액 어디서 확인해?	청구금액
이번 달 청구금액 어디서 확인해요?	청구금액
이번 달 청구금액 어디서 확인하죠?	청구금액
이번 달 청구금액 어디서 확인할까요?	청구금액
이번 달 청구금액 어디서 확인하나요?	청구금액
이번 달 청구금액 어디서 확인해야하죠?	청구금액
이번 달 청구금액 어디서 확인해야할까요?	청구금액
이번 달 청구금액 어디서 확인할수있나요?	청구금액
박스 외부에 표기된 제품과 내부 포장되어 있는 제품이 일치하지 않아요	제품불일치
구매한 제품과 실제제품이 일치하지않아요	제품불일치
박스 외부와 내부 제품이 달라요	제품불일치
구매한 제품에 다른 제품이 포장되어있습니다	제품불일치
구매한 제품에 다른 제품이 들어있어요	제품불일치
박스는 주문한 제품인데 내용물은 다른 제품이에요	제품불일치
구매한 제품이 포장지는 제대로이나 안에 내용물이 다른 제품이 들어있습니다	제품불일치
겉포장지와 내용물이 일치하지않습니다 어떻게 해야하나요?	제품불일치
박스 안 내용물이 제가 주문한 제품과 다릅니다	제품불일치
박스 안 제품이 제가 주문한 제품이 아닌 다른 제품이 들어가있습니다	제품불일치
박스 내용물이 잘못되었습니다 제가 주문한 것과 박스 외부 표기는 동일하나 박스내부제품이 다릅니다	제품불일치
포장지와 내용물이 다릅니다	제품불일치
박스에 포장되어있는 내용물이 제가 주문한 제품과 다릅니다	제품불일치
박스에 포장되어있는 제품이 주문한 제품이 아닙니다	제품불일치
포장과 내용물이 동일하지않습니다	제품불일치
포장과 다른 제품이 들어있습니다	제품불일치
포장과 내용물이 다른제품입니다	제품불일치
상품의 겉과 속이 동일하지않아요	제품불일치
상품의 겉과 속이 다릅니다	제품불일치
제품의 겉과 속이 달라요	제품불일치
제품의 겉과 속이 다릅니다	제품불일치
제품의 겉과 속이 다른게있습니다	제품불일치
제품에 표기된 제품과 내부포장 제품이 달라	제품불일치
제품에 표기된 제품과 내부포장 제품이 달라요	제품불일치
제품에 표기된 제품과 내부포장 제품이 다릅니다	제품불일치
제품에 표기된 제품과 내부포장 제품이 다른데요	제품불일치
제품에 표기된 제품과 내부포장 제품이 다른데 어떡하죠?	제품불일치
제품에 표기된 제품과 내부포장 제품이 다른데 어떻게 해야합니까?	제품불일치
제품에 표기된 제품과 내부포장 제품이 다른데 어떻게 하죠?	제품불일치
제품에 표기된 제품과 내부포장 제품이 다른데 어떻게 해야하는지 알려주세요	제품불일치
제품에 표기된 제품과 내부포장 제품이 다른데 어떻게 해야하는지 궁금합니다	제품불일치
제품에 표기된 제품과 내부포장 제품이 다른데 어떻게해요?	제품불일치
박스 외부에 표기된 제품과 내부 포장되어 있는 제품이 일치하지 않아요 어떻게 해?	제품불일치
박스 외부에 표기된 제품과 내부 포장되어 있는 제품이 일치하지 않아요 어떻게 해요?	제품불일치
박스 외부에 표기된 제품과 내부 포장되어 있는 제품이 일치하지 않아요 어떻게 할까요?	제품불일치
박스 외부에 표기된 제품과 내부 포장되어 있는 제품이 일치하지 않아요 어떻게 해야하나요?	제품불일치
박스 외부에 표기된 제품과 내부 포장되어 있는 제품이 일치하지 않아요 어떻게 해야합니까?	제품불일치
박스 외부에 표기된 제품과 내부 포장되어 있는 제품이 일치하지 않아요 어떻게 해야하는지 알려주세요	제품불일치
박스 외부에 표기된 제품과 내부 포장되어 있는 제품이 일치하지 않아요 어떻게 해야하는지 알려줄수 있나요?	제품불일치
박스 외부에 표기된 제품과 내부 포장되어 있는 제품이 일치하지 않는데 어떻게 해?	제품불일치
박스 외부에 표기된 제품과 내부 포장되어 있는 제품이 일치하지 않는데 어떻게 해요?	제품불일치
박스 외부에 표기된 제품과 내부 포장되어 있는 제품이 일치하지 않는데 어떻게 할까요?	제품불일치
박스 외부에 표기된 제품과 내부 포장되어 있는 제품이 일치하지 않는데 어떻게 해야하나요?	제품불일치
박스 외부에 표기된 제품과 내부 포장되어 있는 제품이 일치하지 않는데 어떻게 해야합니까?	제품불일치
박스 외부에 표기된 제품과 내부 포장되어 있는 제품이 일치하지 않는데 어떻게 해야하는지 알려주세요	제품불일치
박스 외부에 표기된 제품과 내부 포장되어 있는 제품이 일치하지 않는데 어떻게 해야하는지 알려줄수 있나요?	제품불일치
박스 외부에 표기된 제품과 내부 포장되어 있는 제품이 일치하지 않아요 어떻게 해?	제품불일치
박스 외부에 표기된 제품과 내부 포장되어 있는 제품이 일치하지 않아요 어떻게 해요?	제품불일치
박스 외부에 표기된 제품과 내부 포장되어 있는 제품이 일치하지 않아요 어떻게 할까요?	제품불일치
박스 외부에 표기된 제품과 내부 포장되어 있는 제품이 일치하지 않아요 어떻게 해야하나요?	제품불일치
박스 외부에 표기된 제품과 내부 포장되어 있는 제품이 일치하지 않아요 어떻게 해야합니까?	제품불일치
박스 외부에 표기된 제품과 내부 포장되어 있는 제품이 일치하지 않아요 어떻게 해야하는지 알려주세요	제품불일치
박스 외부에 표기된 제품과 내부 포장되어 있는 제품이 일치하지 않아요 어떻게 해야하는지 알려줄수 있나요?	제품불일치
제품 교환은 어떻게 하는 건가요?	교환문의
제품 교환 바랍니다.	교환문의
제품 교환하고 싶습니다	교환문의
제품 교환하고자 합니다	교환문의
제품 교환 어떻게 하는거에요?	교환문의
제품 교환하고 싶어요	교환문의
제품 교환요청드립니다	교환문의
제품 교환 해주세요	교환문의
제품 교환하려면 어떻게 해야하나요?	교환문의
제품 교환 어떻게 해요?	교환문의
제품 교환하는 방법을 알고 싶습니다	교환문의
제품 교환하는 방법은 어디서 확인할 수 있나요?	교환문의
제품 교환하고 싶어요 어디서 신청할 수 있나요?	교환문의
어떻게 제품 교환을 신청해야하나요?	교환문의
어떻게하면 교환신청을 할 수 있을까요?	교환문의
어떻게해야 제품교환이 가능할까요?	교환문의
제품 교환하고싶어요 어디에 신청해야하나요?	교환문의
제품 교환원합니다 어디에 신청해야하나요?	교환문의
제품 교환원합니다 어떻게 신청 할 수있나요?	교환문의
제품 교환 할 수 있나요?	교환문의
제품 교환 어떻게 하죠?	교환문의
제품 바꾸고싶어요 어떻게 해야하나요?	교환문의
제품 바꾸려면 어떻게 하죠?	교환문의
제품 바꾸려면 어디로 신청해야하나요?	교환문의
제품 바꾸고싶어요 어떻게 신청해야 합니까?	교환문의
제품 바꾸고싶은데요 어떻게 해야하는지 알려주세요	교환문의
제품 바꾸고싶은데 방법을 알려주세요	교환문의
제품 바꾸고싶습니다 어떻게 해야해요?	교환문의
제품바꾸고싶습니다 어떻게해야해요?	교환문의
제품 교환	교환문의
제품 바꾸고싶습니다 어떻게해야합니까?	교환문의
제품 바꾸고싶습니다 어떻게 해야합니까?	교환문의
제품 바꾸고싶습니다 어떻게 해야 합니까?	교환문의
상품 바꾸고싶습니다 어떻게 해야합니까?	교환문의
상품바꾸고싶습니다 어떻게 해야합니까?	교환문의
상품교환 어떻게 해?	교환문의
상품교환 어떻게 해요?	교환문의
상품교환 어떻게 하나요?	교환문의
상품교환 어떻게 하죠?	교환문의
상품교환 어떻게 할수있어요?	교환문의
상품교환 어떻게 해야되요?	교환문의
상품교환 어떻게 해야돼요?	교환문의
상품교환 어떻게 할수있나요?	교환문의
제품교환 어떻게 해?	교환문의
제품교환 어떻게 해요?	교환문의
제품교환 어떻게 하나요?	교환문의
제품교환 어떻게 하죠?	교환문의
제품교환 어떻게 할수있어요?	교환문의
제품교환 어떻게 해야되요?	교환문의
제품교환 어떻게 해야돼요?	교환문의
제품교환 어떻게 할수있나요?	교환문의
제품교환바랍니다.	교환문의
제품 교환바랍니다.	교환문의
제품교환 바랍니다.	교환문의
제품교환하고싶습니다	교환문의
제품 교환하고싶습니다	교환문의
제품교환 하고싶습니다	교환문의
제품교환하고자합니다	교환문의
제품 교환하고자합니다	교환문의
제품교환 하고자합니다	교환문의
제품교환 어떻게하는거에요?	교환문의
제품 교환 어떻게하는거에요?	교환문의
제품교환 어떻게 하는거에요?	교환문의
제품 교환 어떻게 하는거에요?	교환문의
제품교환하고싶어요	교환문의
제품 교환하고싶어요	교환문의
제품교환 하고싶어요	교환문의
제품교환요청드립니다	교환문의
제품 교환요청드립니다	교환문의
제품교환 요청드립니다	교환문의
제품교환해주세요	교환문의
제품 교환해주세요	교환문의
제품교환 해주세요	교환문의
제품교환하려면 어떻게해야하나요?	교환문의
제품 교환하려면 어떻게해야하나요?	교환문의
제품교환하려면 어떻게 해야하나요?	교환문의
제품 교환하려면 어떻게 해야하나요?	교환문의
제품교환 어떻게해요?	교환문의
제품 교환 어떻게해요?	교환문의
제품교환 어떻게 해요?	교환문의
제품 교환 어떻게 해요?	교환문의
제품교환하는방법을 알고싶습니다	교환문의
제품 교환하는방법을 알고싶습니다	교환문의
제품교환하는 방법을 알고싶습니다	교환문의
제품교환 하는방법을 알고싶습니다	교환문의
제품교환하는방법을 알고 싶습니다	교환문의
제품 교환하는방법을 알고 싶습니다	교환문의
제품교환 하는방법을 알고 싶습니다	교환문의
제품교환하는 방법을 알고 싶습니다	교환문의
제품교환하는방법은 어디서 확인할수있나요?	교환문의
제품 교환하는방법은 어디서 확인할수있나요?	교환문의
제품교환 하는방법은 어디서 확인할수있나요?	교환문의
제품교환하는 방법은 어디서 확인할수있나요?	교환문의
제품교환하는방법은 어디서 확인할 수 있나요?	교환문의
제품 교환하는방법은 어디서 확인할 수 있나요?	교환문의
제품교환 하는방법은 어디서 확인할 수 있나요?	교환문의
제품교환하는 방법은 어디서 확인할 수 있나요?	교환문의
제품교환하고싶어요 어디서 신청할수있나요?	교환문의
제품 교환하고싶어요 어디서 신청할수있나요?	교환문의
제품교환 하고싶어요 어디서 신청할수있나요?	교환문의
제품교환하고싶어요 어디서 신청할 수 있나요?	교환문의
제품 교환하고싶어요 어디서 신청할 수 있나요?	교환문의
제품교환 하고싶어요 어디서 신청할 수 있나요?	교환문의
제품 교환 하고싶어요 어디서 신청할 수 있나요?	교환문의
어떻게 제품교환을 신청해야하나요?	교환문의
어떻게 제품 교환을 신청해야하나요?	교환문의
어떻게하면 교환신청을 할수있을까요?	교환문의
어떻게하면 교환 신청을 할수있을까요?	교환문의
어떻게하면 교환신청을 할 수 있을까요?	교환문의
어떻게하면 교환 신청을 할 수 있을까요?	교환문의
어떻게해야 제품 교환이 가능할까요?	교환문의
제품교환하고싶어요 어디에 신청해야하나요?	교환문의
제품 교환하고싶어요 어디에 신청해야하나요?	교환문의
제품교환 하고싶어요 어디에 신청해야하나요?	교환문의
제품교환원합니다 어디에 신청해야하나요?	교환문의
제품 교환원합니다 어디에 신청해야하나요?	교환문의
제품교환 원합니다 어디에 신청해야하나요?	교환문의
제품 교환 원합니다 어디에 신청해야하나요?	교환문의
제품교환원합니다 어떻게 신청할수있나요?	교환문의
제품 교환원합니다 어떻게 신청할수있나요?	교환문의
제품교환 원합니다 어떻게 신청할수있나요?	교환문의
제품 교환 원합니다 어떻게 신청할수있나요?	교환문의
제품교환원합니다 어떻게 신청할 수 있나요?	교환문의
제품 교환원합니다 어떻게 신청할 수 있나요?	교환문의
제품교환 원합니다 어떻게 신청할 수 있나요?	교환문의
제품 교환 원합니다 어떻게 신청할 수 있나요?	교환문의
제품교환 할수있나요?	교환문의
제품 교환 할수있나요?	교환문의
제품교환 할 수 있나요?	교환문의
제품교환 어떻게하죠?	교환문의
제품 교환 어떻게하죠?	교환문의
제품교환 어떻게 하죠?	교환문의
제품바꾸고싶어요 어떻게 해야하나요?	교환문의
제품 바꾸고싶어요 어떻게 해야하나요?	교환문의
제품바꾸고싶어요 어떻게 해야하나요?	교환문의
제품바꾸려면 어떻게하죠?	교환문의
제품 바꾸려면 어떻게하죠?	교환문의
제품바꾸려면 어떻게 하죠?	교환문의
제품바꾸려면 어디로 신청해야하나요?	교환문의
제품바꾸고싶어요 어떻게 신청해야합니까?	교환문의
제품 바꾸고싶어요 어떻게 신청해야합니까?	교환문의
제품바꾸고싶어요 어떻게 신청해야 합니까?	교환문의
제품 바꾸고싶어요 어떻게 신청해야 합니까?	교환문의
제품바꾸고싶은데요 어떻게 해야하는지알려주세요	교환문의
제품 바꾸고싶은데요 어떻게 해야하는지알려주세요	교환문의
제품바꾸고싶은데요 어떻게 해야하는지 알려주세요	교환문의
제품 바꾸고싶은데요 어떻게 해야하는지 알려주세요	교환문의
제품바꾸고싶은데 방법을알려주세요	교환문의
제품 바꾸고싶은데 방법을알려주세요	교환문의
제품바꾸고싶은데 방법을 알려주세요	교환문의
제품 바꾸고싶은데 방법을 알려주세요	교환문의
제품바꾸고싶습니다 어떻게해야해요?	교환문의
제품 바꾸고싶습니다 어떻게해야해요?	교환문의
제품바꾸고싶습니다 어떻게 해야해요?	교환문의
제품교환	교환문의
상품교환 어떻게해?	교환문의
상품 교환 어떻게 해?	교환문의
상품 교환 어떻게해?	교환문의
상품교환 어떻게해요?	교환문의
상품 교환 어떻게해요?	교환문의
상품 교환 어떻게 해요?	교환문의
상품교환 어떻게하나요?	교환문의
상품 교환 어떻게하나요?	교환문의
상품 교환 어떻게 하나요?	교환문의
상품교환 어떻게하죠?	교환문의
상품 교환 어떻게하죠?	교환문의
상품 교환 어떻게 하죠?	교환문의
상품 교환 어떻게 할수있어요?	교환문의
상품교환 어떻게 할 수 있어요?	교환문의
상품 교환 어떻게 할 수 있어요?	교환문의
상품 교환 어떻게 해야되요?	교환문의
상품교환 어떻게 해야 되요?	교환문의
상품 교환 어떻게 해야 되요?	교환문의
상품 교환 어떻게 해야돼요?	교환문의
상품교환 어떻게 해야 돼요?	교환문의
상품 교환 어떻게 해야 돼요?	교환문의
상품 교환 어떻게 할수있나요?	교환문의
상품교환 어떻게 할 수 있나요?	교환문의
상품 교환 어떻게 할 수 있나요?	교환문의
제품교환 어떻게해?	교환문의
제품 교환 어떻게해?	교환문의
제품 교환 어떻게 해?	교환문의
제품교환 어떻게해요?	교환문의
제품 교환 어떻게해요?	교환문의
제품 교환 어떻게 해요?	교환문의
제품교환 어떻게하나요?	교환문의
제품 교환 어떻게하나요?	교환문의
제품 교환 어떻게 하나요?	교환문의
제품교환 어떻게하죠?	교환문의
제품 교환 어떻게하죠?	교환문의
제품 교환 어떻게 하죠?	교환문의
제품교환 어떻게할수있어요?	교환문의
제품 교환 어떻게할수있어요?	교환문의
제품 교환 어떻게 할수있어요?	교환문의
제품교환 어떻게해야되요?	교환문의
제품 교환 어떻게해야되요?	교환문의
제품 교환 어떻게 해야되요?	교환문의
제품교환 어떻게해야돼요?	교환문의
제품 교환 어떻게해야돼요?	교환문의
제품 교환 어떻게 해야돼요?	교환문의
제품교환 어떻게 할 수 있나요?	교환문의
제품 교환 어떻게 할 수 있나요?	교환문의
제품 교환 어떻게 할수있나요?	교환문의
이번 달 교환 마감일이 언제인가요?	교환문의
교환마감일이 언제인가요?	교환문의
이번 달 교환 마감일이 언제인가요?	교환문의
교환 마감일이 언제인가요?	교환문의
교환 마감일이 알고 싶습니다	교환문의
교환 마감일 알려주세요	교환문의
교환 마감일 언제까지 인가요?	교환문의
교환 마감일 확인 부탁드립니다	교환문의
교환 마감일 확인 후 알려주세요	교환문의
교환 마감일 알고 싶습니다	교환문의
교환마감일 이번달은 언제인가요?	교환문의
교환마감일이 언제인지 알고싶습니다	교환문의
교환마감일이 이번달은 언제일까요?	교환문의
이번달 교환마감일 언제?	교환문의
이번달 교환마감일 언제인지 궁금해요	교환문의
교환마감일 이번달 언젠지 알 수 있을까요?	교환문의
이번 달 교환 마감일 저번 달과 동일한가요?	교환문의
이번 달 교환 마감일 기존과 동일한가요?	교환문의
이번 달 교환 마감일 기존하고 동일한가요?	교환문의
이번 달 교환 마감일 저번 달과 같은가요?	교환문의
이번 달 교환 마감일 저번 달과 동일합니까?	교환문의
이번 달 교환 마감일 저번 달과 동일해요?	교환문의
이번달교환마감일 저번달교환마감일과 같나요?	교환문의
이번달 교환마감일 저번달 교환마감일과 같나요?	교환문의
이번 달 교환마감일 저번달 교환마감일과 같나요?	교환문의
이번달 교환마감일 저번 달 교환마감일과 같나요?	교환문의
이번 달 교환마감일 저번 달 교환마감일과 같나요?	교환문의
교환마감일 어떻게 확인해?	교환문의
교환마감일 어떻게 확인해요?	교환문의
교환마감일 어떻게 확인하죠?	교환문의
교환마감일 어떻게 확인하나요?	교환문의
이번달 교환마감일 어떻게 확인해?	교환문의
이번달 교환마감일 어떻게 확인해요?	교환문의
이번달 교환마감일 어떻게 확인하죠?	교환문의
이번달 교환마감일 어떻게 확인하나요?	교환문의
교환 마감 날짜 어떻게 확인해?	교환문의
교환 마감 날짜 어떻게 확인해요?	교환문의
교환 마감 날짜 어떻게 확인하죠?	교환문의
교환 마감 날짜 어떻게 확인하나요?	교환문의
교환신청마감일 어떻게 확인해?	교환문의
교환신청마감일 어떻게 확인해요?	교환문의
교환신청마감일 어떻게 확인하죠?	교환문의
교환신청마감일 어떻게 확인하나요?	교환문의
교환마감일 어떻게 확인할수있는지 알려주세요	교환문의
교환마감일 어떻게 확인할수있는지 알려주실수있나요	교환문의
교환마감일 어떻게 확인해야하는지 알려주실수있나요	교환문의
교환마감일 어떻게 확인해야하는지 알려주세요	교환문의
교환마감날짜 어떻게 확인할수있는지 알려주세요	교환문의
교환마감날짜 어떻게 확인할수있는지 알려주실수있나요	교환문의
교환마감날짜 어떻게 확인해야하는지 알려주실수있나요	교환문의
교환마감날짜 어떻게 확인해야하는지 알려주세요	교환문의
교환신청마감일 어떻게 확인할수있는지 알려주세요	교환문의
교환신청마감일 어떻게 확인할수있는지 알려주실수있나요	교환문의
교환신청마감일 어떻게 확인해야하는지 알려주실수있나요	교환문의
교환신청마감일 어떻게 확인해야하는지 알려주세요	교환문의
이번달 교환마감일이 언제인가요?	교환문의
이번 달 교환마감일이 언제인가요?	교환문의
이번달 교환 마감일이 언제인가요?	교환문의
이번 달 교환 마감일이 언제인가요?	교환문의
교환마감일이 언제인가요?	교환문의
교환마감일이 알고싶습니다	교환문의
교환 마감일이 알고싶습니다	교환문의
교환마감일이 알고 싶습니다	교환문의
교환마감일 알려주세요	교환문의
교환마감일 언제까지인가요?	교환문의
교환 마감일 언제까지인가요?	교환문의
교환마감일 언제까지 인가요?	교환문의
교환마감일 확인부탁드립니다	교환문의
교환 마감일 확인부탁드립니다	교환문의
교환마감일 확인 부탁드립니다	교환문의
교환마감일 확인후알려주세요	교환문의
교환 마감일 확인후알려주세요	교환문의
교환마감일 확인 후 알려주세요	교환문의
교환 마감일 확인 후 알려주세요	교환문의
교환마감일 알고싶습니다	교환문의
교환 마감일 알고싶습니다	교환문의
교환마감일 알고 싶습니다	교환문의
교환 마감일 알고 싶습니다	교환문의
교환 마감일 이번달은 언제인가요?	교환문의
교환마감일 이번 달은 언제인가요?	교환문의
교환 마감일 이번 달은 언제인가요?	교환문의
교환 마감일이 언제인지 알고싶습니다	교환문의
교환 마감일이 이번달은 언제일까요?	교환문의
교환마감일이 이번 달은 언제일까요?	교환문의
교환 마감일이 이번 달은 언제일까요?	교환문의
이번 달 교환마감일 언제?	교환문의
이번달 교환 마감일 언제?	교환문의
이번 달 교환 마감일 언제?	교환문의
이번 달 교환마감일 언제인지 궁금해요	교환문의
이번달 교환 마감일 언제인지 궁금해요	교환문의
이번 달 교환 마감일 언제인지 궁금해요	교환문의
이번달 교환 마감일 언제인지궁금해요	교환문의
이번 달 교환 마감일 언제인지궁금해요	교환문의
교환마감일 이번달 언젠지 알수있을까요?	교환문의
교환 마감일 이번달 언젠지 알수있을까요?	교환문의
교환마감일 이번 달 언젠지 알수있을까요?	교환문의
교환 마감일 이번 달 언젠지 알수있을까요?	교환문의
교환마감일 이번 달 언젠지 알 수 있을까요?	교환문의
교환 마감일 이번 달 언젠지 알 수 있을까요?	교환문의
이번달 교환마감일 저번달과 동일한가요?	교환문의
이번 달 교환마감일 저번달과 동일한가요?	교환문의
이번달 교환 마감일 저번달과 동일한가요?	교환문의
이번 달 교환 마감일 저번달과 동일한가요?	교환문의
이번달 교환 마감일 저번 달과 동일한가요?	교환문의
이번달 교환마감일 기존과 동일한가요?	교환문의
이번 달 교환마감일 기존과 동일한가요?	교환문의
이번달 교환 마감일 기존과 동일한가요?	교환문의
이번 달 교환 마감일 기존과 동일한가요?	교환문의
이번달 교환마감일 기존하고 동일한가요?	교환문의
이번 달 교환마감일 기존하고 동일한가요?	교환문의
이번달 교환 마감일 기존하고 동일한가요?	교환문의
이번달 교환마감일 저번달과 같은가요?	교환문의
이번 달 교환마감일 저번달과 같은가요?	교환문의
이번달 교환 마감일 저번달과 같은가요?	교환문의
이번 달 교환 마감일 저번달과 같은가요?	교환문의
이번달 교환 마감일 저번 달과 같은가요?	교환문의
이번달 교환마감일 저번달과 동일합니까?	교환문의
이번 달 교환마감일 저번달과 동일합니까?	교환문의
이번달 교환 마감일 저번달과 동일합니까?	교환문의
이번 달 교환 마감일 저번달과 동일합니까?	교환문의
이번달 교환 마감일 저번 달과 동일합니까?	교환문의
이번달 교환마감일 저번달과 동일해요?	교환문의
이번 달 교환마감일 저번달과 동일해요?	교환문의
이번달 교환 마감일 저번달과 동일해요?	교환문의
이번 달 교환 마감일 저번달과 동일해요?	교환문의
이번달 교환 마감일 저번 달과 동일해요?	교환문의
이번 달 교환마감일 어떻게 확인해?	교환문의
이번달 교환 마감일 어떻게 확인해?	교환문의
이번 달 교환 마감일 어떻게 확인해?	교환문의
이번 달 교환마감일 어떻게 확인해요?	교환문의
이번달 교환 마감일 어떻게 확인해요?	교환문의
이번 달 교환 마감일 어떻게 확인해요?	교환문의
이번 달 교환마감일 어떻게 확인하죠?	교환문의
이번달 교환 마감일 어떻게 확인하죠?	교환문의
이번 달 교환 마감일 어떻게 확인하죠?	교환문의
이번 달 교환마감일 어떻게 확인하나요?	교환문의
이번달 교환 마감일 어떻게 확인하나요?	교환문의
이번 달 교환 마감일 어떻게 확인하나요?	교환문의
교환마감날짜 어떻게 확인해?	교환문의
교환 마감날짜 어떻게 확인해?	교환문의
교환마감 날짜 어떻게 확인해?	교환문의
교환마감날짜 어떻게 확인해요?	교환문의
교환 마감날짜 어떻게 확인해요?	교환문의
교환마감 날짜 어떻게 확인해요?	교환문의
교환마감날짜 어떻게 확인하죠?	교환문의
교환 마감날짜 어떻게 확인하죠?	교환문의
교환마감 날짜 어떻게 확인하죠?	교환문의
교환마감날짜 어떻게 확인하나요?	교환문의
교환 마감날짜 어떻게 확인하나요?	교환문의
교환마감 날짜 어떻게 확인하나요?	교환문의
교환 신청마감일 어떻게 확인해?	교환문의
교환신청 마감일 어떻게 확인해?	교환문의
교환 신청 마감일 어떻게 확인해?	교환문의
교환 신청마감일 어떻게 확인해요?	교환문의
교환신청 마감일 어떻게 확인해요?	교환문의
교환 신청 마감일 어떻게 확인해요?	교환문의
교환 신청마감일 어떻게 확인하죠?	교환문의
교환신청 마감일 어떻게 확인하죠?	교환문의
교환 신청 마감일 어떻게 확인하죠?	교환문의
교환 신청마감일 어떻게 확인하나요?	교환문의
교환신청 마감일 어떻게 확인하나요?	교환문의
교환 신청 마감일 어떻게 확인하나요?	교환문의
교환 마감일 어떻게 확인할수있는지 알려주세요	교환문의
교환마감일 어떻게 확인할 수 있는지 알려주세요	교환문의
교환 마감일 어떻게 확인할 수 있는지 알려주세요	교환문의
교환 마감일 어떻게 확인할수있는지 알려주실수있나요	교환문의
교환마감일 어떻게 확인할 수 있는지 알려주실수있나요	교환문의
교환 마감일 어떻게 확인할 수 있는지 알려주실수있나요	교환문의
교환마감일 어떻게 확인할 수 있는지 알려주실 수 있나요	교환문의
교환 마감일 어떻게 확인할 수 있는지 알려주실 수 있나요	교환문의
교환 마감일 어떻게 확인해야하는지 알려주실수있나요	교환문의
교환마감일 어떻게 확인해야하는지 알려주실 수 있나요	교환문의
교환 마감일 어떻게 확인해야하는지 알려주실 수 있나요	교환문의
교환 마감일 어떻게 확인해야하는지 알려주세요	교환문의
교환 마감날짜 어떻게 확인할수있는지 알려주세요	교환문의
교환마감날짜 어떻게 확인할 수 있는지 알려주세요	교환문의
교환 마감날짜 어떻게 확인할 수 있는지 알려주세요	교환문의
교환 마감날짜 어떻게 확인할수있는지 알려주실수있나요	교환문의
교환마감날짜 어떻게 확인할 수 있는지 알려주실수있나요	교환문의
교환 마감날짜 어떻게 확인할 수 있는지 알려주실수있나요	교환문의
교환마감날짜 어떻게 확인할 수 있는지 알려주실 수 있나요	교환문의
교환 마감날짜 어떻게 확인할 수 있는지 알려주실 수 있나요	교환문의
교환 마감날짜 어떻게 확인해야하는지 알려주실수있나요	교환문의
교환마감날짜 어떻게 확인해야하는지 알려주실 수 있나요	교환문의
교환 마감날짜 어떻게 확인해야하는지 알려주실 수 있나요	교환문의
교환 마감날짜 어떻게 확인해야하는지 알려주세요	교환문의
교환 신청마감일 어떻게 확인할수있는지 알려주세요	교환문의
교환신청마감일 어떻게 확인할 수 있는지 알려주세요	교환문의
교환 신청마감일 어떻게 확인할 수 있는지 알려주세요	교환문의
교환 신청마감일 어떻게 확인할수있는지 알려주실수있나요	교환문의
교환신청마감일 어떻게 확인할 수 있는지 알려주실수있나요	교환문의
교환 신청마감일 어떻게 확인할 수 있는지 알려주실수있나요	교환문의
교환신청마감일 어떻게 확인할 수 있는지 알려주실 수 있나요	교환문의
교환 신청마감일 어떻게 확인할 수 있는지 알려주실 수 있나요	교환문의
교환 신청마감일 어떻게 확인해야하는지 알려주실수있나요	교환문의
교환신청마감일 어떻게 확인해야하는지 알려주실 수 있나요	교환문의
교환 신청마감일 어떻게 확인해야하는지 알려주실 수 있나요	교환문의
교환 신청마감일 어떻게 확인해야하는지 알려주세요	교환문의
교환은 언제 회수해 가나요?	교환문의
교환 신청했는데 회수 언제 하나요?	교환문의
교환 회수 언제 되나요?	교환문의
교환 신청했습니다 언제 회수되나요?	교환문의
교환 신청했습니다 언제 회수될까요?	교환문의
교환 신청했습니다 회수 언제 될까요?	교환문의
교환 신청했는데요 회수 언제 되나요?	교환문의
교환 신청했는데 언제 회수되나요?	교환문의
교환 회수 언제 해가요?	교환문의
교환 언제 회수해요?	교환문의
언제 교환 회수해가나요?	교환문의
언제 교환신청한거 회수해가요?	교환문의
언제 회수해가나요 교환신청했는데	교환문의
교환신청했는데 언제 회수해요?	교환문의
교환신청한거 언제 회수하는지 알 수 있을까요?	교환문의
교환신청하려하는데 회수가 언제 되는지 궁금합니다	교환문의
교환 회수 언제되나요?	교환문의
교환 회수 언제 해가나요?	교환문의
교환 회수는 언제 해가는지 궁금해요	교환문의
언제 교환 회수하는지 궁금해요	교환문의
교환 신청했습니다 언제 회수해가는지 궁금합니다	교환문의
교환 신청했습니다 회수일정 궁금합니다	교환문의
교환 신청했습니다 회수일정이 어떻게 되나요?	교환문의
교환신청했습니다 회수일정이 어떻게되나요?	교환문의
교환신청했습니다 회수일정이 어떻게 되나요?	교환문의
교환신청했습니다 회수 일정이 어떻게되나요?	교환문의
교환신청했습니다 회수 일정이 어떻게 되나요?	교환문의
교환신청했는데 회수일정이 어떻게되나?	교환문의
교환 신청했는데 회수일정이 어떻게되나?	교환문의
교환신청했는데 회수 일정이 어떻게되나?	교환문의
교환신청했는데 회수일정이 어떻게 되나?	교환문의
교환신청했는데 회수 일정이 어떻게 되나?	교환문의
교환 신청했는데 회수 일정이 어떻게 되나?	교환문의
교환회수일자 어떻게 확인해?	교환문의
교환회수일자 어떻게 확인해요?	교환문의
교환회수일자 어떻게 확인하죠?	교환문의
교환회수일자 어떻게 확인하나요?	교환문의
교환회수일자 어떻게 확인할까요?	교환문의
교환회수일자 어떻게 확인할수있죠?	교환문의
교환회수일자 어떻게 확인할수있을까요?	교환문의
교환회수날짜 어떻게 확인해?	교환문의
교환회수날짜 어떻게 확인해요?	교환문의
교환회수날짜 어떻게 확인하죠?	교환문의
교환회수날짜 어떻게 확인하나요?	교환문의
교환회수날짜 어떻게 확인할까요?	교환문의
교환회수날짜 어떻게 확인할수있죠?	교환문의
교환회수날짜 어떻게 확인할수있을까요?	교환문의
교환신청했는데 회수 언제하나요?	교환문의
교환 신청했는데 회수 언제하나요?	교환문의
교환신청했는데 회수 언제 하나요?	교환문의
교환회수 언제되나요?	교환문의
교환 회수 언제되나요?	교환문의
교환회수 언제 되나요?	교환문의
교환신청했습니다 언제 회수되나요?	교환문의
교환신청했습니다 언제 회수될까요?	교환문의
교환신청했습니다 회수 언제될까요?	교환문의
교환 신청했습니다 회수 언제될까요?	교환문의
교환신청했는데요 회수 언제되나요?	교환문의
교환 신청했는데요 회수 언제되나요?	교환문의
교환신청했는데요 회수 언제 되나요?	교환문의
교환 신청했는데요 회수 언제 되나요?	교환문의
교환신청했는데 언제 회수되나요?	교환문의
교환회수 언제해가요?	교환문의
교환 회수 언제해가요?	교환문의
교환회수 언제 해가요?	교환문의
교환 언제회수해요?	교환문의
교환신청한거 언제 회수하는지 알수있을까요?	교환문의
교환회수 언제되나요?	교환문의
교환회수 언제해가나요?	교환문의
교환 회수 언제해가나요?	교환문의
교환회수 언제 해가나요?	교환문의
교환회수는 언제해가는지 궁금해요	교환문의
교환 회수는 언제해가는지 궁금해요	교환문의
교환회수는 언제 해가는지 궁금해요	교환문의
교환 회수는 언제 해가는지 궁금해요	교환문의
교환신청했습니다 언제 회수해가는지 궁금합니다	교환문의
교환신청했습니다 회수일정궁금합니다	교환문의
교환 신청했습니다 회수일정궁금합니다	교환문의
교환신청했습니다 회수일정 궁금합니다	교환문의
교환 신청했습니다 회수일정 궁금합니다	교환문의
교환신청했습니다 회수일정이 어떻게되나요?	교환문의
교환 신청했습니다 회수일정이 어떻게되나요?	교환문의
교환신청 했습니다 회수일정이 어떻게되나요?	교환문의
교환신청했습니다 회수일정이 어떻게 되나요?	교환문의
교환 신청했습니다 회수일정이 어떻게 되나요?	교환문의
교환신청 했습니다 회수일정이 어떻게 되나요?	교환문의
교환 회수일자 어떻게 확인해?	교환문의
교환회수 일자 어떻게 확인해?	교환문의
교환 회수 일자 어떻게 확인해?	교환문의
교환 회수일자 어떻게 확인해요?	교환문의
교환회수 일자 어떻게 확인해요?	교환문의
교환 회수 일자 어떻게 확인해요?	교환문의
교환 회수일자 어떻게 확인하죠?	교환문의
교환회수 일자 어떻게 확인하죠?	교환문의
교환 회수 일자 어떻게 확인하죠?	교환문의
교환 회수일자 어떻게 확인하나요?	교환문의
교환회수 일자 어떻게 확인하나요?	교환문의
교환 회수 일자 어떻게 확인하나요?	교환문의
교환 회수일자 어떻게 확인할까요?	교환문의
교환회수 일자 어떻게 확인할까요?	교환문의
교환 회수 일자 어떻게 확인할까요?	교환문의
교환 회수일자 어떻게 확인할수있죠?	교환문의
교환회수 일자 어떻게 확인할수있죠?	교환문의
교환 회수 일자 어떻게 확인할수있죠?	교환문의
교환회수일자 어떻게 확인할 수 있죠?	교환문의
교환 회수일자 어떻게 확인할 수 있죠?	교환문의
교환회수 일자 어떻게 확인할 수 있죠?	교환문의
교환 회수 일자 어떻게 확인할 수 있죠?	교환문의
교환 회수일자 어떻게 확인할수있을까요?	교환문의
교환회수 일자 어떻게 확인할수있을까요?	교환문의
교환 회수 일자 어떻게 확인할수있을까요?	교환문의
교환회수일자 어떻게 확인할 수 있을까요?	교환문의
교환 회수일자 어떻게 확인할 수 있을까요?	교환문의
교환회수 일자 어떻게 확인할 수 있을까요?	교환문의
교환 회수 일자 어떻게 확인할 수 있을까요?	교환문의
교환 회수날짜 어떻게 확인해?	교환문의
교환회수 날짜 어떻게 확인해?	교환문의
교환 회수 날짜 어떻게 확인해?	교환문의
교환 회수날짜 어떻게 확인해요?	교환문의
교환회수 날짜 어떻게 확인해요?	교환문의
교환 회수 날짜 어떻게 확인해요?	교환문의
교환 회수날짜 어떻게 확인하죠?	교환문의
교환회수 날짜 어떻게 확인하죠?	교환문의
교환 회수 날짜 어떻게 확인하죠?	교환문의
교환 회수날짜 어떻게 확인하나요?	교환문의
교환회수 날짜 어떻게 확인하나요?	교환문의
교환 회수 날짜 어떻게 확인하나요?	교환문의
교환 회수날짜 어떻게 확인할까요?	교환문의
교환회수 날짜 어떻게 확인할까요?	교환문의
교환 회수 날짜 어떻게 확인할까요?	교환문의
교환 회수날짜 어떻게 확인할수있죠?	교환문의
교환회수 날짜 어떻게 확인할수있죠?	교환문의
교환 회수 날짜 어떻게 확인할수있죠?	교환문의
교환회수날짜 어떻게 확인할 수 있죠?	교환문의
교환 회수날짜 어떻게 확인할 수 있죠?	교환문의
교환회수 날짜 어떻게 확인할 수 있죠?	교환문의
교환 회수 날짜 어떻게 확인할 수 있죠?	교환문의
교환 회수날짜 어떻게 확인할수있을까요?	교환문의
교환회수 날짜 어떻게 확인할수있을까요?	교환문의
교환 회수 날짜 어떻게 확인할수있을까요?	교환문의
교환회수날짜 어떻게 확인할 수 있을까요?	교환문의
교환 회수날짜 어떻게 확인할 수 있을까요?	교환문의
교환회수 날짜 어떻게 확인할 수 있을까요?	교환문의
교환 회수 날짜 어떻게 확인할 수 있을까요?	교환문의
교환 가능한 제품이 어떻게 되나요?	교환문의
교환 가능 제품이 있나요?	교환문의
교환가능 제품이있나요?	교환문의
교환 가능제품이 있나요?	교환문의
교환가능제품이 있나요?	교환문의
교환가능제품이있나요?	교환문의
교환가능한 제품이 어떻게되나요?	교환문의
교환가능한제품이 어떻게되나요?	교환문의
교환가능한 제품이 어떻게 되나요?	교환문의
교환 가능한 제품이 어떻게 됩니까?	교환문의
교환가능한제품이 어떻게됩니까?	교환문의
교환가능한제품이 어떻게 됩니까?	교환문의
교환가능한 제품이 어떻게됩니까?	교환문의
교환 가능한제품이 어떻게됩니까?	교환문의
교환 가능한제품이 어떻게 됩니까?	교환문의
교환 가능한 제품이 어떻게됩니까?	교환문의
교환 가능한 제품이 어떻게 됩니까?	교환문의
그룹 내 교환이 가능한 상품인가요?	교환문의
그룹내 교환이 가능한 상품인가요?	교환문의
그룹내교환이 가능한 상품인가요?	교환문의
그룹내교환이 가능한상품인가요?	교환문의
그룹 내 교환이 가능한상품인가요?	교환문의
그룹 내 교환이 가능한 상품있나요?	교환문의
그룹 내 교환이 가능한상품있나요?	교환문의
그룹내교환이 가능한 상품 있나요?	교환문의
그룹 내  교환이 가능한 상품있나요?	교환문의
그룹 내 교환이 가능한 상품이 있습니까?	교환문의
교환 가능한 제품 확인 어떻게 해?	교환문의
교환 가능한 제품 확인 어떻게 하죠?	교환문의
교환 가능한 제품 확인 어떻게 해요?	교환문의
 교환 가능한 제품 확인 어떻게 하나요?	교환문의
교환 가능한 제품 확인 어떻게 할까요?	교환문의
교환 가능한 제품 확인 어떻게 합니까?	교환문의
교환 가능한 제품 확인 어떻게 해야하죠?	교환문의
교환 가능한 제품 확인 어떻게 해야되요?	교환문의
교환 가능한 제품 확인 어떻게 해야돼요?	교환문의
교환 가능한 제품 확인 어떻게 해야됩니까?	교환문의
교환 가능한 제품 확인 어떻게 해야합니까?	교환문의
교환 가능한 제품 확인 어떻게 할수있습니까?	교환문의
교환 가능한 제품 확인 어떻게 할수있나요?	교환문의
교환 가능한 제품 확인 어떻게 해야하는지 알려주세요	교환문의
교환 가능한 제품 확인 어떻게 해야되는지 알려주세요	교환문의
같은그룹내상품	교환문의
같은그룹내상품 어떻게 확인해?	교환문의
같은그룹내상품 어떻게 확인해요?	교환문의
같은그룹내상품 어떻게 확인하죠?	교환문의
같은그룹내상품 어떻게 확인하나요?	교환문의
같은그룹내상품 어떻게 확인합니까?	교환문의
같은그룹내상품 어떻게 확인할까요?	교환문의
같은그룹내상품 어떻게 확인할수있죠?	교환문의
같은그룹내상품 어떻게 확인할수있나요?	교환문의
같은그룹내상품 어떻게 확인할수있습니까?	교환문의
같은그룹내상품 어떻게 확인가능한가요?	교환문의
같은그룹내제품	교환문의
같은그룹내제품 어떻게 확인해?	교환문의
같은그룹내제품 어떻게 확인해요?	교환문의
같은그룹내제품 어떻게 확인하죠?	교환문의
같은그룹내제품 어떻게 확인하나요?	교환문의
같은그룹내제품 어떻게 확인합니까?	교환문의
같은그룹내제품 어떻게 확인할까요?	교환문의
같은그룹내제품 어떻게 확인할수있죠?	교환문의
같은그룹내제품 어떻게 확인할수있나요?	교환문의
같은그룹내제품 어떻게 확인할수있습니까?	교환문의
같은그룹내제품 어떻게 확인가능한가요?	교환문의
그룹내 교환이 가능한 상품이있습니까?	교환문의
그룹 내 교환이 가능한 상품이있습니까?	교환문의
그룹내 교환이 가능한 상품이 있습니까?	교환문의
그룹 내 교환이 가능한 상품이 있습니까?	교환문의
교환가능한제품 확인어떻게해?	교환문의
교환 가능한제품 확인어떻게해?	교환문의
교환가능한 제품 확인어떻게해?	교환문의
교환 가능한 제품 확인어떻게해?	교환문의
교환가능한제품 확인 어떻게해?	교환문의
교환 가능한제품 확인 어떻게해?	교환문의
교환가능한 제품 확인 어떻게해?	교환문의
교환 가능한 제품 확인 어떻게해?	교환문의
교환가능한제품 확인 어떻게 해?	교환문의
교환 가능한제품 확인 어떻게 해?	교환문의
교환가능한 제품 확인 어떻게 해?	교환문의
교환 가능한 제품 확인 어떻게 해?	교환문의
교환가능한제품 확인 어떻게 해?	교환문의
교환가능한제품 확인어떻게하죠?	교환문의
교환 가능한제품 확인어떻게하죠?	교환문의
교환가능한 제품 확인어떻게하죠?	교환문의
교환 가능한 제품 확인어떻게하죠?	교환문의
교환가능한제품 확인 어떻게하죠?	교환문의
교환 가능한제품 확인 어떻게하죠?	교환문의
교환가능한 제품 확인 어떻게하죠?	교환문의
교환 가능한 제품 확인 어떻게하죠?	교환문의
교환가능한제품 확인 어떻게 하죠?	교환문의
교환 가능한제품 확인 어떻게 하죠?	교환문의
교환가능한 제품 확인 어떻게 하죠?	교환문의
교환 가능한 제품 확인 어떻게 하죠?	교환문의
교환가능한제품 확인어떻게해요?	교환문의
교환 가능한제품 확인어떻게해요?	교환문의
교환가능한 제품 확인어떻게해요?	교환문의
교환 가능한 제품 확인어떻게해요?	교환문의
교환가능한제품 확인 어떻게해요?	교환문의
교환 가능한제품 확인 어떻게해요?	교환문의
교환가능한 제품 확인 어떻게해요?	교환문의
교환 가능한 제품 확인 어떻게해요?	교환문의
교환가능한제품 확인 어떻게 해요?	교환문의
교환 가능한제품 확인 어떻게 해요?	교환문의
교환가능한 제품 확인 어떻게 해요?	교환문의
교환 가능한 제품 확인 어떻게 해요?	교환문의
교환가능한제품 확인어떻게하나요?	교환문의
 교환 가능한제품 확인어떻게하나요?	교환문의
 교환가능한 제품 확인어떻게하나요?	교환문의
 교환 가능한 제품 확인어떻게하나요?	교환문의
 교환가능한제품 확인 어떻게하나요?	교환문의
 교환 가능한제품 확인 어떻게하나요?	교환문의
 교환가능한 제품 확인 어떻게하나요?	교환문의
 교환 가능한 제품 확인 어떻게하나요?	교환문의
 교환가능한제품 확인 어떻게 하나요?	교환문의
 교환 가능한제품 확인 어떻게 하나요?	교환문의
 교환가능한 제품 확인 어떻게 하나요?	교환문의
 교환 가능한 제품 확인 어떻게 하나요?	교환문의
교환가능한제품 확인어떻게할까요?	교환문의
교환 가능한제품 확인어떻게할까요?	교환문의
교환가능한 제품 확인어떻게할까요?	교환문의
교환 가능한 제품 확인어떻게할까요?	교환문의
교환가능한제품 확인 어떻게할까요?	교환문의
교환 가능한제품 확인 어떻게할까요?	교환문의
교환가능한 제품 확인 어떻게할까요?	교환문의
교환 가능한 제품 확인 어떻게할까요?	교환문의
교환가능한제품 확인 어떻게 할까요?	교환문의
교환 가능한제품 확인 어떻게 할까요?	교환문의
교환가능한 제품 확인 어떻게 할까요?	교환문의
교환 가능한 제품 확인 어떻게 할까요?	교환문의
교환가능한제품 확인어떻게합니까?	교환문의
교환 가능한제품 확인어떻게합니까?	교환문의
교환가능한 제품 확인어떻게합니까?	교환문의
교환 가능한 제품 확인어떻게합니까?	교환문의
교환가능한제품 확인 어떻게합니까?	교환문의
교환 가능한제품 확인 어떻게합니까?	교환문의
교환가능한 제품 확인 어떻게합니까?	교환문의
교환 가능한 제품 확인 어떻게합니까?	교환문의
교환가능한제품 확인 어떻게 합니까?	교환문의
교환 가능한제품 확인 어떻게 합니까?	교환문의
교환가능한 제품 확인 어떻게 합니까?	교환문의
교환 가능한 제품 확인 어떻게 합니까?	교환문의
교환가능한제품 확인어떻게해야하죠?	교환문의
교환 가능한제품 확인어떻게해야하죠?	교환문의
교환가능한 제품 확인어떻게해야하죠?	교환문의
교환 가능한 제품 확인어떻게해야하죠?	교환문의
교환가능한제품 확인 어떻게해야하죠?	교환문의
교환 가능한제품 확인 어떻게해야하죠?	교환문의
교환가능한 제품 확인 어떻게해야하죠?	교환문의
교환 가능한 제품 확인 어떻게해야하죠?	교환문의
교환가능한제품 확인 어떻게 해야하죠?	교환문의
교환 가능한제품 확인 어떻게 해야하죠?	교환문의
교환가능한 제품 확인 어떻게 해야하죠?	교환문의
교환 가능한 제품 확인 어떻게 해야하죠?	교환문의
교환가능한제품 확인어떻게해야되요?	교환문의
교환 가능한제품 확인어떻게해야되요?	교환문의
교환가능한 제품 확인어떻게해야되요?	교환문의
교환 가능한 제품 확인어떻게해야되요?	교환문의
교환가능한제품 확인 어떻게해야되요?	교환문의
교환 가능한제품 확인 어떻게해야되요?	교환문의
교환가능한 제품 확인 어떻게해야되요?	교환문의
교환 가능한 제품 확인 어떻게해야되요?	교환문의
교환가능한제품 확인 어떻게 해야되요?	교환문의
교환 가능한제품 확인 어떻게 해야되요?	교환문의
교환가능한 제품 확인 어떻게 해야되요?	교환문의
교환 가능한 제품 확인 어떻게 해야되요?	교환문의
교환가능한제품 확인어떻게해야돼요?	교환문의
교환 가능한제품 확인어떻게해야돼요?	교환문의
교환가능한 제품 확인어떻게해야돼요?	교환문의
교환 가능한 제품 확인어떻게해야돼요?	교환문의
교환가능한제품 확인 어떻게해야돼요?	교환문의
교환 가능한제품 확인 어떻게해야돼요?	교환문의
교환가능한 제품 확인 어떻게해야돼요?	교환문의
교환 가능한 제품 확인 어떻게해야돼요?	교환문의
교환가능한제품 확인 어떻게 해야돼요?	교환문의
교환 가능한제품 확인 어떻게 해야돼요?	교환문의
교환가능한 제품 확인 어떻게 해야돼요?	교환문의
교환 가능한 제품 확인 어떻게 해야돼요?	교환문의
교환가능한제품 확인어떻게해야됩니까?	교환문의
교환 가능한제품 확인어떻게해야됩니까?	교환문의
교환가능한 제품 확인어떻게해야됩니까?	교환문의
교환 가능한 제품 확인어떻게해야됩니까?	교환문의
교환가능한제품 확인 어떻게해야됩니까?	교환문의
교환 가능한제품 확인 어떻게해야됩니까?	교환문의
교환가능한 제품 확인 어떻게해야됩니까?	교환문의
교환 가능한 제품 확인 어떻게해야됩니까?	교환문의
교환가능한제품 확인 어떻게 해야됩니까?	교환문의
교환 가능한제품 확인 어떻게 해야됩니까?	교환문의
교환가능한 제품 확인 어떻게 해야됩니까?	교환문의
교환 가능한 제품 확인 어떻게 해야됩니까?	교환문의
교환가능한제품 확인어떻게해야합니까?	교환문의
교환 가능한제품 확인어떻게해야합니까?	교환문의
교환가능한 제품 확인어떻게해야합니까?	교환문의
교환 가능한 제품 확인어떻게해야합니까?	교환문의
교환가능한제품 확인 어떻게해야합니까?	교환문의
교환 가능한제품 확인 어떻게해야합니까?	교환문의
교환가능한 제품 확인 어떻게해야합니까?	교환문의
교환 가능한 제품 확인 어떻게해야합니까?	교환문의
교환가능한제품 확인 어떻게 해야합니까?	교환문의
교환 가능한제품 확인 어떻게 해야합니까?	교환문의
교환가능한 제품 확인 어떻게 해야합니까?	교환문의
교환 가능한 제품 확인 어떻게 해야합니까?	교환문의
교환가능한제품 확인어떻게할수있습니까?	교환문의
교환 가능한제품 확인어떻게할수있습니까?	교환문의
교환가능한 제품 확인어떻게할수있습니까?	교환문의
교환 가능한 제품 확인어떻게할수있습니까?	교환문의
교환가능한제품 확인 어떻게할수있습니까?	교환문의
교환 가능한제품 확인 어떻게할수있습니까?	교환문의
교환가능한 제품 확인 어떻게할수있습니까?	교환문의
교환 가능한 제품 확인 어떻게할수있습니까?	교환문의
교환가능한제품 확인 어떻게 할수있습니까?	교환문의
교환 가능한제품 확인 어떻게 할수있습니까?	교환문의
교환가능한 제품 확인 어떻게 할수있습니까?	교환문의
교환 가능한 제품 확인 어떻게 할수있습니까?	교환문의
교환가능한제품 확인 어떻게 할 수 있습니까?	교환문의
교환 가능한제품 확인 어떻게 할 수 있습니까?	교환문의
교환가능한 제품 확인 어떻게 할 수 있습니까?	교환문의
교환 가능한 제품 확인 어떻게 할 수 있습니까?	교환문의
교환가능한제품 확인어떻게할수있나요?	교환문의
교환 가능한제품 확인어떻게할수있나요?	교환문의
교환가능한 제품 확인어떻게할수있나요?	교환문의
교환 가능한 제품 확인어떻게할수있나요?	교환문의
교환가능한제품 확인 어떻게할수있나요?	교환문의
교환 가능한제품 확인 어떻게할수있나요?	교환문의
교환가능한 제품 확인 어떻게할수있나요?	교환문의
교환 가능한 제품 확인 어떻게할수있나요?	교환문의
교환가능한제품 확인 어떻게할 수 있나요?	교환문의
교환 가능한제품 확인 어떻게할 수 있나요?	교환문의
교환가능한 제품 확인 어떻게할 수 있나요?	교환문의
교환 가능한 제품 확인 어떻게할 수 있나요?	교환문의
교환가능한제품 확인 어떻게해야하는지알려주세요	교환문의
교환 가능한제품 확인 어떻게해야하는지알려주세요	교환문의
교환가능한 제품 확인 어떻게해야하는지알려주세요	교환문의
교환 가능한 제품 확인 어떻게해야하는지알려주세요	교환문의
교환가능한제품 확인 어떻게 해야하는지알려주세요	교환문의
교환 가능한제품 확인 어떻게 해야하는지알려주세요	교환문의
교환가능한 제품 확인 어떻게 해야하는지알려주세요	교환문의
교환 가능한 제품 확인 어떻게 해야하는지알려주세요	교환문의
교환가능한제품 확인 어떻게 해야하는지 알려주세요	교환문의
교환 가능한제품 확인 어떻게 해야하는지 알려주세요	교환문의
교환가능한 제품 확인 어떻게 해야하는지 알려주세요	교환문의
교환 가능한 제품 확인 어떻게 해야하는지 알려주세요	교환문의
교환가능한제품 확인 어떻게해야되는지알려주세요	교환문의
교환 가능한제품 확인 어떻게해야되는지알려주세요	교환문의
교환가능한 제품 확인 어떻게해야되는지알려주세요	교환문의
교환 가능한 제품 확인 어떻게해야되는지알려주세요	교환문의
교환가능한제품 확인 어떻게 해야되는지알려주세요	교환문의
교환 가능한제품 확인 어떻게 해야되는지알려주세요	교환문의
교환가능한 제품 확인 어떻게 해야되는지알려주세요	교환문의
교환 가능한 제품 확인 어떻게 해야되는지알려주세요	교환문의
교환가능한제품 확인 어떻게 해야되는지 알려주세요	교환문의
교환 가능한제품 확인 어떻게 해야되는지 알려주세요	교환문의
교환가능한 제품 확인 어떻게 해야되는지 알려주세요	교환문의
교환 가능한 제품 확인 어떻게 해야되는지 알려주세요	교환문의
교환 내역을 조회할 수 있나요?	교환문의
교환 내역 조회해주세요	교환문의
교환 내역 조회 부탁드립니다	교환문의
교환 내역 조회 하고싶어요	교환문의
교환 내역 확인 가능할까요?	교환문의
교환 신청했는데 확인해주세요	교환문의
교환 내역 조회 어떻게 하나요?	교환문의
교환 내역 조회하고 싶어요	교환문의
교환 내역 조회하고싶은데 어떻게 하나요?	교환문의
교환 내역 조회법 알려주세요	교환문의
교환 내역 조회법 알려주실수있나요	교환문의
교환 내역 조회는 어떻게 할 수 있나요?	교환문의
교환 내역 조회를 하고싶어요 어디서 확인 할 수 있나요?	교환문의
교환 내역 조회는 어디에서 확인 가능한가요?	교환문의
어디에서 교환내역조회 할 수 있어요?	교환문의
어떻게 교환 내역 조회할 수 있는지 알려주세요	교환문의
어떤 제품 교환했는지 확인 가능합니까?	교환문의
어떤 제품 교환했는지 확인 부탁드립니다	교환문의
교환 신청 내역 조회 부탁드립니다	교환문의
교환 신청 내역 조회해주세요	교환문의
교환 신청내역 조회 어디서 하나요?	교환문의
교환내역을 조회할수있나요?	교환문의
교환내역을 조회할 수 있나요?	교환문의
교환내역을 조회 할수있나요?	교환문의
교환 내역을 조회할수있나요?	교환문의
교환 내역을 조회할수있나요	교환문의
교환 내역을 조회할 수 있나요?	교환문의
교환 내역을 조회할수 있나요?	교환문의
교환 내역 조회 어떻게 해?	교환문의
교환 내역 조회 어떻게 해요?	교환문의
교환 내역 조회 어떻게 하죠?	교환문의
교환 내역 조회 어떻게 하나요?	교환문의
교환 내역 조회 어떻게 할수있죠?	교환문의
교환 내역 조회 어떻게 할수있나요?	교환문의
교환 내역 조회 어떻게 할수있습니까?	교환문의
교환 내역 조회 어떻게 할수있는지 알려주세요	교환문의
교환내역조회하는 방법 알려줘	교환문의
교환내역조회하는 방법 알려주세요	교환문의
교환내역조회하는 방법 알려줘요	교환문의
교환내역조회하는 방법 알려주실수있나요	교환문의
교환이력조회하는 방법 알려줘	교환문의
교환이력조회하는 방법 알려주세요	교환문의
교환이력조회하는 방법 알려줘요	교환문의
교환이력조회하는 방법 알려주실수있나요	교환문의
교환이력 조회할 수 있나요?	교환문의
교환이력 조회할 수 있어?	교환문의
교환이력 조회할 수 있어요?	교환문의
교환이력 조회할 수 있습니까?	교환문의
교환이력 조회할 수 있으십니까?	교환문의
교환이력 조회가 필요해	교환문의
교환이력 조회가 필요해요	교환문의
교환이력 조회가 필요합니다	교환문의
교환이력조회 필요해	교환문의
교환이력조회 필요해요	교환문의
교환이력조회 필요합니다	교환문의
교환내역 조회가 필요해	교환문의
교환내역 조회가 필요해요	교환문의
교환내역 조회가 필요합니다	교환문의
교환내역조회 필요해	교환문의
교환내역조회 필요해요	교환문의
교환내역조회 필요합니다	교환문의
교환내역조회해주세요	교환문의
교환 내역조회해주세요	교환문의
교환내역 조회해주세요	교환문의
교환내역조회 부탁드립니다	교환문의
교환 내역조회 부탁드립니다	교환문의
교환내역 조회 부탁드립니다	교환문의
교환내역조회 하고싶어요	교환문의
교환 내역조회 하고싶어요	교환문의
교환내역 조회 하고싶어요	교환문의
교환내역확인 가능할까요?	교환문의
교환 내역확인 가능할까요?	교환문의
교환내역 확인 가능할까요?	교환문의
교환신청했는데 확인해주세요	교환문의
교환 신청했는데 확인해주세요	교환문의
교환신청했는데 확인해 주세요	교환문의
교환 신청했는데 확인해 주세요	교환문의
교환내역조회 어떻게하나요?	교환문의
교환 내역조회 어떻게하나요?	교환문의
교환내역 조회 어떻게하나요?	교환문의
교환 내역 조회 어떻게하나요?	교환문의
교환내역조회 어떻게 하나요?	교환문의
교환 내역조회 어떻게 하나요?	교환문의
교환내역 조회 어떻게 하나요?	교환문의
교환 내역 조회 어떻게 하나요?	교환문의
교환내역조회하고싶어요	교환문의
교환 내역조회하고싶어요	교환문의
교환내역 조회하고싶어요	교환문의
교환내역조회 하고싶어요	교환문의
교환 내역 조회하고싶어요	교환문의
교환내역조회하고싶은데 어떻게하나요?	교환문의
교환 내역조회하고싶은데 어떻게하나요?	교환문의
교환내역 조회하고싶은데 어떻게하나요?	교환문의
교환내역조회 하고싶은데 어떻게하나요?	교환문의
교환 내역 조회하고싶은데 어떻게하나요?	교환문의
교환 내역 조회하고 싶은데 어떻게하나요?	교환문의
교환내역조회하고싶은데 어떻게 하나요?	교환문의
교환 내역조회하고싶은데 어떻게 하나요?	교환문의
교환내역 조회하고싶은데 어떻게 하나요?	교환문의
교환내역조회 하고싶은데 어떻게 하나요?	교환문의
교환 내역 조회하고싶은데 어떻게 하나요?	교환문의
교환 내역조회 하고싶은데 어떻게 하나요?	교환문의
교환내역조회법 알려주세요	교환문의
교환 내역조회법 알려주세요	교환문의
교환내역 조회법 알려주세요	교환문의
교환 내역 조회법 알려주세요	교환문의
교환내역조회법 알려주실수있나요	교환문의
교환 내역조회법 알려주실수있나요	교환문의
교환내역 조회법 알려주실수있나요	교환문의
교환 내역 조회법 알려주실수있나요	교환문의
교환내역조회법 알려주실 수 있나요	교환문의
교환 내역조회법 알려주실 수 있나요	교환문의
교환내역 조회법 알려주실 수 있나요	교환문의
교환 내역 조회법 알려주실 수 있나요	교환문의
교환내역조회는 어떻게 할수있나요?	교환문의
교환 내역조회는 어떻게 할수있나요?	교환문의
교환내역 조회는 어떻게 할수있나요?	교환문의
교환 내역 조회는 어떻게 할수있나요?	교환문의
교환내역조회는 어떻게 할 수 있나요?	교환문의
교환 내역조회는 어떻게 할 수 있나요?	교환문의
교환내역 조회는 어떻게 할 수 있나요?	교환문의
교환 내역 조회는 어떻게 할 수 있나요?	교환문의
교환내역조회를 하고싶어요 어디서 확인할수있나요?	교환문의
교환 내역조회를 하고싶어요 어디서 확인할수있나요?	교환문의
교환내역 조회를 하고싶어요 어디서 확인할수있나요?	교환문의
교환 내역 조회를 하고싶어요 어디서 확인할수있나요?	교환문의
교환내역조회를 하고싶어요 어디서 확인할 수 있나요?	교환문의
교환 내역조회를 하고싶어요 어디서 확인할 수 있나요?	교환문의
교환내역 조회를 하고싶어요 어디서 확인할 수 있나요?	교환문의
교환 내역 조회를 하고싶어요 어디서 확인할 수 있나요?	교환문의
교환내역조회는 어디에서 확인가능한가요?	교환문의
교환 내역조회는 어디에서 확인가능한가요?	교환문의
교환내역 조회는 어디에서 확인가능한가요?	교환문의
교환 내역 조회는 어디에서 확인가능한가요?	교환문의
교환내역조회는 어디에서 확인 가능한가요?	교환문의
교환 내역조회는 어디에서 확인 가능한가요?	교환문의
교환내역 조회는 어디에서 확인 가능한가요?	교환문의
교환 내역 조회는 어디에서 확인 가능한가요?	교환문의
어디에서 교환내역조회 할수있어요?	교환문의
어디에서 교환 내역조회 할수있어요?	교환문의
어디에서 교환내역 조회 할수있어요?	교환문의
어디에서 교환 내역 조회 할수있어요?	교환문의
어디에서 교환내역조회 할 수 있어요?	교환문의
어디에서 교환 내역조회 할 수 있어요?	교환문의
어디에서 교환내역 조회 할 수 있어요?	교환문의
어디에서 교환 내역 조회 할 수 있어요?	교환문의
어떻게 교환내역조회 할수있는지 알려주세요	교환문의
어떻게 교환 내역조회 할수있는지 알려주세요	교환문의
어떻게 교환내역 조회 할수있는지 알려주세요	교환문의
어떻게 교환 내역 조회 할수있는지 알려주세요	교환문의
어떻게 교환내역조회 할 수 있는지 알려주세요	교환문의
어떻게 교환 내역조회 할 수 있는지 알려주세요	교환문의
어떻게 교환내역 조회 할 수 있는지 알려주세요	교환문의
어떻게 교환 내역 조회 할 수 있는지 알려주세요	교환문의
어떤 제품교환했는지 확인가능합니까?	교환문의
어떤 제품 교환했는지 확인가능합니까?	교환문의
어떤 제품교환했는지 확인 가능합니까?	교환문의
어떤 제품 교환했는지 확인 가능합니까?	교환문의
어떤 제품교환했는지 확인부탁드립니다	교환문의
어떤 제품 교환했는지 확인부탁드립니다	교환문의
어떤 제품교환했는지 확인 부탁드립니다	교환문의
어떤 제품 교환했는지 확인 부탁드립니다	교환문의
교환신청내역 조회부탁드립니다	교환문의
교환 신청내역 조회부탁드립니다	교환문의
교환신청 내역 조회부탁드립니다	교환문의
교환 신청 내역 조회부탁드립니다	교환문의
교환신청내역 조회 부탁드립니다	교환문의
교환 신청내역 조회 부탁드립니다	교환문의
교환신청 내역 조회 부탁드립니다	교환문의
교환 신청 내역 조회 부탁드립니다	교환문의
교환신청내역 조회해주세요	교환문의
교환 신청내역 조회해주세요	교환문의
교환신청 내역 조회해주세요	교환문의
교환 신청 내역 조회해주세요	교환문의
교환신청내역 조회 어디서하나요?	교환문의
교환 신청내역 조회 어디서하나요?	교환문의
교환신청 내역 조회 어디서하나요?	교환문의
교환 신청 내역 조회 어디서하나요?	교환문의
교환신청내역 조회 어디서 하나요?	교환문의
교환 신청내역 조회 어디서 하나요?	교환문의
교환신청 내역 조회 어디서 하나요?	교환문의
교환 신청 내역 조회 어디서 하나요?	교환문의
교환내역조회 어떻게해?	교환문의
교환 내역조회 어떻게해?	교환문의
교환내역 조회 어떻게해?	교환문의
교환 내역 조회 어떻게해?	교환문의
교환내역조회 어떻게 해?	교환문의
교환 내역조회 어떻게 해?	교환문의
교환내역 조회 어떻게 해?	교환문의
교환 내역 조회 어떻게 해?	교환문의
교환내역조회 어떻게해요?	교환문의
교환 내역조회 어떻게해요?	교환문의
교환내역 조회 어떻게해요?	교환문의
교환 내역 조회 어떻게해요?	교환문의
교환내역조회 어떻게 해요?	교환문의
교환 내역조회 어떻게 해요?	교환문의
교환내역 조회 어떻게 해요?	교환문의
교환 내역 조회 어떻게 해요?	교환문의
교환내역조회 어떻게하죠?	교환문의
교환 내역조회 어떻게하죠?	교환문의
교환내역 조회 어떻게하죠?	교환문의
교환 내역 조회 어떻게하죠?	교환문의
교환내역조회 어떻게 하죠?	교환문의
교환 내역조회 어떻게 하죠?	교환문의
교환내역 조회 어떻게 하죠?	교환문의
교환 내역 조회 어떻게 하죠?	교환문의
교환내역조회 어떻게하나요?	교환문의
교환 내역조회 어떻게하나요?	교환문의
교환내역 조회 어떻게하나요?	교환문의
교환 내역 조회 어떻게하나요?	교환문의
교환내역조회 어떻게 하나요?	교환문의
교환 내역조회 어떻게 하나요?	교환문의
교환내역 조회 어떻게 하나요?	교환문의
교환 내역 조회 어떻게 하나요?	교환문의
교환내역조회 어떻게할수있죠?	교환문의
교환 내역조회 어떻게할수있죠?	교환문의
교환내역 조회 어떻게할수있죠?	교환문의
교환 내역 조회 어떻게할수있죠?	교환문의
교환내역조회 어떻게 할수있죠?	교환문의
교환 내역조회 어떻게 할수있죠?	교환문의
교환내역 조회 어떻게 할수있죠?	교환문의
교환 내역 조회 어떻게 할수있죠?	교환문의
교환내역조회 어떻게할 수 있죠?	교환문의
교환 내역조회 어떻게할 수 있죠?	교환문의
교환내역 조회 어떻게할 수 있죠?	교환문의
교환 내역 조회 어떻게할 수 있죠?	교환문의
교환내역조회 어떻게 할 수 있죠?	교환문의
교환 내역조회 어떻게 할 수 있죠?	교환문의
교환내역 조회 어떻게 할 수 있죠?	교환문의
교환 내역 조회 어떻게 할 수 있죠?	교환문의
교환내역조회 어떻게할수있나요?	교환문의
교환 내역조회 어떻게할수있나요?	교환문의
교환내역 조회 어떻게할수있나요?	교환문의
교환 내역 조회 어떻게할수있나요?	교환문의
교환내역조회 어떻게 할수있나요?	교환문의
교환 내역조회 어떻게 할수있나요?	교환문의
교환내역 조회 어떻게 할수있나요?	교환문의
교환 내역 조회 어떻게 할수있나요?	교환문의
교환내역조회 어떻게할 수 있나요?	교환문의
교환 내역조회 어떻게할 수 있나요?	교환문의
교환내역 조회 어떻게할 수 있나요?	교환문의
교환 내역 조회 어떻게할 수 있나요?	교환문의
교환내역조회 어떻게 할 수 있나요?	교환문의
교환 내역조회 어떻게 할 수 있나요?	교환문의
교환내역 조회 어떻게 할 수 있나요?	교환문의
교환 내역 조회 어떻게 할 수 있나요?	교환문의
교환내역조회 어떻게할수있습니까?	교환문의
교환 내역조회 어떻게할수있습니까?	교환문의
교환내역 조회 어떻게할수있습니까?	교환문의
교환 내역 조회 어떻게할수있습니까?	교환문의
교환내역조회 어떻게 할수있습니까?	교환문의
교환 내역조회 어떻게 할수있습니까?	교환문의
교환내역 조회 어떻게 할수있습니까?	교환문의
교환 내역 조회 어떻게 할수있습니까?	교환문의
교환내역조회 어떻게할 수 있습니까?	교환문의
교환 내역조회 어떻게할 수 있습니까?	교환문의
교환내역 조회 어떻게할 수 있습니까?	교환문의
교환 내역 조회 어떻게할 수 있습니까?	교환문의
교환내역조회 어떻게 할 수 있습니까?	교환문의
교환 내역조회 어떻게 할 수 있습니까?	교환문의
교환내역 조회 어떻게 할 수 있습니까?	교환문의
교환 내역 조회 어떻게 할 수 있습니까?	교환문의
교환내역조회 어떻게할수있는지 알려주세요	교환문의
교환 내역조회 어떻게할수있는지 알려주세요	교환문의
교환내역 조회 어떻게할수있는지 알려주세요	교환문의
교환 내역 조회 어떻게할수있는지 알려주세요	교환문의
교환내역조회 어떻게 할수있는지 알려주세요	교환문의
교환 내역조회 어떻게 할수있는지 알려주세요	교환문의
교환내역 조회 어떻게 할수있는지 알려주세요	교환문의
교환 내역 조회 어떻게 할수있는지 알려주세요	교환문의
교환내역조회 어떻게할 수 있는지 알려주세요	교환문의
교환 내역조회 어떻게할 수 있는지 알려주세요	교환문의
교환내역 조회 어떻게할 수 있는지 알려주세요	교환문의
교환 내역 조회 어떻게할 수 있는지 알려주세요	교환문의
교환내역조회 어떻게 할 수 있는지 알려주세요	교환문의
교환 내역조회 어떻게 할 수 있는지 알려주세요	교환문의
교환내역 조회 어떻게 할 수 있는지 알려주세요	교환문의
교환 내역 조회 어떻게 할 수 있는지 알려주세요	교환문의
교환 내역조회하는 방법 알려줘	교환문의
교환내역 조회하는 방법 알려줘	교환문의
교환 내역 조회하는 방법 알려줘	교환문의
교환 내역조회하는 방법 알려주세요	교환문의
교환내역 조회하는 방법 알려주세요	교환문의
교환 내역 조회하는 방법 알려주세요	교환문의
교환 내역조회하는 방법 알려줘요	교환문의
교환내역 조회하는 방법 알려줘요	교환문의
교환 내역 조회하는 방법 알려줘요	교환문의
교환 내역조회하는 방법 알려주실수있나요	교환문의
교환내역 조회하는 방법 알려주실수있나요	교환문의
교환 내역 조회하는 방법 알려주실수있나요	교환문의
교환 내역조회하는 방법 알려주실 수 있나요	교환문의
교환내역 조회하는 방법 알려주실 수 있나요	교환문의
교환 내역 조회하는 방법 알려주실 수 있나요	교환문의
교환 이력조회하는 방법 알려줘	교환문의
교환이력 조회하는 방법 알려줘	교환문의
교환 이력 조회하는 방법 알려줘	교환문의
교환 이력조회하는 방법 알려주세요	교환문의
교환이력 조회하는 방법 알려주세요	교환문의
교환 이력 조회하는 방법 알려주세요	교환문의
교환 이력조회하는 방법 알려줘요	교환문의
교환이력 조회하는 방법 알려줘요	교환문의
교환 이력 조회하는 방법 알려줘요	교환문의
교환 이력조회하는 방법 알려주실수있나요	교환문의
교환이력 조회하는 방법 알려주실수있나요	교환문의
교환 이력 조회하는 방법 알려주실수있나요	교환문의
교환 이력조회하는 방법 알려주실 수 있나요	교환문의
교환이력 조회하는 방법 알려주실 수 있나요	교환문의
교환 이력 조회하는 방법 알려주실 수 있나요	교환문의
교환 이력 조회할 수 있나요?	교환문의
교환 이력 조회할 수 있어?	교환문의
교환 이력 조회할 수 있어요?	교환문의
교환 이력 조회할 수 있습니까?	교환문의
교환 이력 조회할 수 있으십니까?	교환문의
교환 이력 조회가 필요해	교환문의
교환 이력 조회가 필요해요	교환문의
교환 이력 조회가 필요합니다	교환문의
교환 이력조회 필요해	교환문의
교환이력 조회 필요해	교환문의
교환 이력 조회 필요해	교환문의
교환 이력조회 필요해요	교환문의
교환이력 조회 필요해요	교환문의
교환 이력 조회 필요해요	교환문의
교환 이력조회 필요합니다	교환문의
교환이력 조회 필요합니다	교환문의
교환 이력 조회 필요합니다	교환문의
교환 내역조회 필요해	교환문의
교환내역 조회 필요해	교환문의
교환 내역 조회 필요해	교환문의
교환 내역조회 필요해요	교환문의
교환내역 조회 필요해요	교환문의
교환 내역 조회 필요해요	교환문의
교환 내역조회 필요합니다	교환문의
교환내역 조회 필요합니다	교환문의
교환 내역 조회 필요합니다	교환문의
개봉한 제품도 교환이 가능한가요?	교환문의
개봉한 제품도 교환이 가능한가요?	교환문의
개봉한 제품 교환 가능한지 궁금합니다	교환문의
개봉한 제품 교환 가능할까요?	교환문의
개봉한 제품 교환하고 싶습니다	교환문의
개봉한 제품을 교환하려면 어떻게 해야하나요?	교환문의
개봉한 제품을 교환하려면 어디로 신청해야하나요?	교환문의
개봉한 제품을 교환하고싶습니다 어떻게 해야할까요?	교환문의
개봉한 제품을 교환하고싶은데요 어디서 신청 할 수 있나요?	교환문의
개봉제품을 교환하고싶습니다 어떻게 하나요?	교환문의
개봉제품을 교환하고싶어요 어디에서 할 수 있나요?	교환문의
개봉한 제품도 교환이 가능한지 궁금합니다	교환문의
제품 교환 가능 품목에 개봉한 제품도 포함되어 있나요?	교환문의
제품 교환 가능 품목에 개봉한 제품도 포함되어 있는지 확인 부탁드립니다	교환문의
개봉한 제품을 교환하고싶습니다 절차가 어떻게 되나요?	교환문의
개봉한 제품을 교환하고 싶은데 가능할까요?	교환문의
개봉된 제품 교환 가능한가요?	교환문의
개봉된 상품 교환 가능한가요?	교환문의
개봉된 상품 교환하고싶습니다	교환문의
개봉된 제품 교환하고싶습니다	교환문의
개봉된 제품도 교환이 됩니까?	교환문의
개봉한 상품도 교환이 됩니까?	교환문의
개봉한상품도 교환이되나요?	교환문의
개봉한 상품도 교환이되나요?	교환문의
개봉한상품도 교환이 되나요?	교환문의
개봉 상품도 교환이 되나요?	교환문의
개봉상품도 교환이되나요?	교환문의
개봉상품도 교환이 될까요?	교환문의
개봉상품도 교환이될까요?	교환문의
개봉 상품도 교환이될까요?	교환문의
개봉 상품도 교환이 될까요?	교환문의
개봉한 제품 교환 어떻게 해?	교환문의
개봉한 제품 교환 어떻게 해요?	교환문의
개봉한 제품 교환 어떻게 하나요?	교환문의
개봉한 제품 교환 어떻게 합니까?	교환문의
개봉한 제품 교환 어떻게 할까요?	교환문의
개봉한 제품 교환 어떻게 해야하죠?	교환문의
개봉한 제품 교환 어떻게 해야되죠?	교환문의
개봉한 제품 교환 어떻게 해야돼죠?	교환문의
개봉한 제품 교환 어떻게 해야할까요?	교환문의
개봉한 제품 교환 어떻게 해야합니까?	교환문의
개봉한 제품 교환 어떻게 해야되나요?	교환문의
개봉한 제품 교환 어떻게 할수있나요?	교환문의
개봉한 제품 교환 어떻게 해야되는지 알려주세요	교환문의
개봉한 제품 교환 어떻게 할수있는지 알려주세요	교환문의
개봉한제품도 교환이가능한가요?	교환문의
개봉한제품도 교환이 가능한가요?	교환문의
개봉한 제품도 교환이가능한가요?	교환문의
개봉한제품 교환 가능한지궁금합니다	교환문의
개봉한제품 교환 가능한지 궁금합니다	교환문의
개봉한 제품 교환 가능한지궁금합니다	교환문의
개봉한제품 교환 가능할까요?	교환문의
개봉한제품 교환하고 싶습니다	교환문의
개봉한제품 교환하고싶습니다	교환문의
개봉한제품을 교환하려면 어떻게 해야하나요?	교환문의
개봉한제품을 교환하려면 어디로 신청해야하나요?	교환문의
개봉한제품을 교환하고싶습니다 어떻게 해야할까요?	교환문의
개봉한제품을 교환하고싶은데요 어디서 신청할수있나요?	교환문의
개봉한 제품을 교환하고싶은데요 어디서 신청할수있나요?	교환문의
개봉한제품을 교환하고 싶은데요 어디서 신청할수있나요?	교환문의
개봉한 제품을 교환하고 싶은데요 어디서 신청할수있나요?	교환문의
개봉한제품을 교환하고 싶은데요 어디서 신청 할 수 있나요?	교환문의
개봉한 제품을 교환하고 싶은데요 어디서 신청 할 수 있나요?	교환문의
개봉제품을 교환하고싶습니다 어떻게하나요?	교환문의
개봉 제품을 교환하고싶습니다 어떻게하나요?	교환문의
개봉제품을 교환하고 싶습니다 어떻게하나요?	교환문의
개봉 제품을 교환하고 싶습니다 어떻게하나요?	교환문의
개봉제품을 교환하고 싶습니다 어떻게 하나요?	교환문의
개봉 제품을 교환하고 싶습니다 어떻게 하나요?	교환문의
개봉제품을 교환하고싶어요 어디에서 할수있나요?	교환문의
개봉 제품을 교환하고싶어요 어디에서 할수있나요?	교환문의
개봉제품을 교환하고 싶어요 어디에서 할수있나요?	교환문의
개봉 제품을 교환하고 싶어요 어디에서 할수있나요?	교환문의
개봉제품을 교환하고 싶어요 어디에서 할 수있나요?	교환문의
개봉 제품을 교환하고 싶어요 어디에서 할 수있나요?	교환문의
개봉한제품도 교환이 가능한지 궁금합니다	교환문의
제품교환가능품목에 개봉한제품도 포함되어있나요?	교환문의
제품 교환가능품목에 개봉한제품도 포함되어있나요?	교환문의
제품교환 가능품목에 개봉한제품도 포함되어있나요?	교환문의
제품교환가능 품목에 개봉한제품도 포함되어있나요?	교환문의
제품교환가능품목에 개봉한 제품도 포함되어있나요?	교환문의
제품 교환가능품목에 개봉한 제품도 포함되어있나요?	교환문의
제품교환 가능품목에 개봉한 제품도 포함되어있나요?	교환문의
제품교환가능 품목에 개봉한 제품도 포함되어있나요?	교환문의
제품교환가능품목에 개봉한제품도 포함되어있는지 확인부탁드립니다	교환문의
제품 교환가능품목에 개봉한제품도 포함되어있는지 확인부탁드립니다	교환문의
제품교환 가능품목에 개봉한제품도 포함되어있는지 확인부탁드립니다	교환문의
제품교환가능 품목에 개봉한제품도 포함되어있는지 확인부탁드립니다	교환문의
제품교환가능품목에 개봉한 제품도 포함되어있는지 확인부탁드립니다	교환문의
제품 교환가능품목에 개봉한 제품도 포함되어있는지 확인부탁드립니다	교환문의
제품교환 가능품목에 개봉한 제품도 포함되어있는지 확인부탁드립니다	교환문의
제품교환가능 품목에 개봉한 제품도 포함되어있는지 확인부탁드립니다	교환문의
제품교환가능품목에 개봉한 제품도 포함되어있는지 확인 부탁드립니다	교환문의
제품 교환가능품목에 개봉한 제품도 포함되어있는지 확인 부탁드립니다	교환문의
제품교환 가능품목에 개봉한 제품도 포함되어있는지 확인 부탁드립니다	교환문의
제품교환가능 품목에 개봉한 제품도 포함되어있는지 확인 부탁드립니다	교환문의
개봉한제품을 교환하고싶습니다 절차가 어떻게 되나요?	교환문의
개봉한제품을 교환하고싶은데 가능할까요?	교환문의
개봉한 제품을 교환하고싶은데 가능할까요?	교환문의
개봉된제품 교환가능한가요?	교환문의
개봉된 제품 교환가능한가요?	교환문의
개봉된제품 교환 가능한가요?	교환문의
개봉된 제품 교환 가능한가요?	교환문의
개봉된상품 교환가능한가요?	교환문의
개봉된 상품 교환가능한가요?	교환문의
개봉된상품 교환 가능한가요?	교환문의
개봉된 상품 교환 가능한가요?	교환문의
개봉된상품 교환하고싶습니다	교환문의
개봉된 상품 교환하고싶습니다	교환문의
개봉된상품 교환하고 싶습니다	교환문의
개봉된 상품 교환하고 싶습니다	교환문의
개봉된제품 교환하고싶습니다	교환문의
개봉된 제품 교환하고싶습니다	교환문의
개봉된제품 교환하고 싶습니다	교환문의
개봉된 제품 교환하고 싶습니다	교환문의
개봉된제품도 교환이됩니까?	교환문의
개봉된 제품도 교환이됩니까?	교환문의
개봉된제품도 교환이 됩니까?	교환문의
개봉된 제품도 교환이 됩니까?	교환문의
개봉된상품도 교환이됩니까?	교환문의
개봉된 상품도 교환이됩니까?	교환문의
개봉된상품도 교환이 됩니까?	교환문의
개봉된 상품도 교환이 됩니까?	교환문의
개봉한제품 교환 어떻게해?	교환문의
개봉한 제품 교환 어떻게해?	교환문의
개봉한제품 교환 어떻게 해?	교환문의
개봉한 제품 교환 어떻게 해?	교환문의
개봉한제품 교환 어떻게해요?	교환문의
개봉한 제품 교환 어떻게해요?	교환문의
개봉한제품 교환 어떻게 해요?	교환문의
개봉한 제품 교환 어떻게 해요?	교환문의
개봉한제품 교환 어떻게하나요?	교환문의
개봉한 제품 교환 어떻게하나요?	교환문의
개봉한제품 교환 어떻게 하나요?	교환문의
개봉한 제품 교환 어떻게 하나요?	교환문의
개봉한제품 교환 어떻게합니까?	교환문의
개봉한 제품 교환 어떻게합니까?	교환문의
개봉한제품 교환 어떻게 합니까?	교환문의
개봉한 제품 교환 어떻게 합니까?	교환문의
개봉한제품 교환 어떻게할까요?	교환문의
개봉한 제품 교환 어떻게할까요?	교환문의
개봉한제품 교환 어떻게 할까요?	교환문의
개봉한 제품 교환 어떻게 할까요?	교환문의
개봉한제품 교환 어떻게해야하죠?	교환문의
개봉한 제품 교환 어떻게해야하죠?	교환문의
개봉한제품 교환 어떻게 해야하죠?	교환문의
개봉한 제품 교환 어떻게 해야하죠?	교환문의
개봉한제품 교환 어떻게해야되죠?	교환문의
개봉한 제품 교환 어떻게해야되죠?	교환문의
개봉한제품 교환 어떻게 해야되죠?	교환문의
개봉한 제품 교환 어떻게 해야되죠?	교환문의
개봉한제품 교환 어떻게해야돼죠?	교환문의
개봉한 제품 교환 어떻게해야돼죠?	교환문의
개봉한제품 교환 어떻게 해야돼죠?	교환문의
개봉한 제품 교환 어떻게 해야돼죠?	교환문의
개봉한제품 교환 어떻게해야할까요?	교환문의
개봉한 제품 교환 어떻게해야할까요?	교환문의
개봉한제품 교환 어떻게 해야할까요?	교환문의
개봉한 제품 교환 어떻게 해야할까요?	교환문의
개봉한제품 교환 어떻게해야합니까?	교환문의
개봉한 제품 교환 어떻게해야합니까?	교환문의
개봉한제품 교환 어떻게 해야합니까?	교환문의
개봉한 제품 교환 어떻게 해야합니까?	교환문의
개봉한제품 교환 어떻게해야되나요?	교환문의
개봉한 제품 교환 어떻게해야되나요?	교환문의
개봉한제품 교환 어떻게 해야되나요?	교환문의
개봉한 제품 교환 어떻게 해야되나요?	교환문의
개봉한제품 교환 어떻게할수있나요?	교환문의
개봉한 제품 교환 어떻게할수있나요?	교환문의
개봉한제품 교환 어떻게 할수있나요?	교환문의
개봉한 제품 교환 어떻게 할수있나요?	교환문의
개봉한제품 교환 어떻게할 수 있나요?	교환문의
개봉한 제품 교환 어떻게할 수 있나요?	교환문의
개봉한제품 교환 어떻게 할 수 있나요?	교환문의
개봉한 제품 교환 어떻게 할 수 있나요?	교환문의
개봉한제품 교환 어떻게해야되는지 알려주세요	교환문의
개봉한 제품 교환 어떻게해야되는지 알려주세요	교환문의
개봉한제품 교환 어떻게 해야되는지 알려주세요	교환문의
개봉한 제품 교환 어떻게 해야되는지 알려주세요	교환문의
개봉한제품 교환 어떻게할수있는지 알려주세요	교환문의
개봉한 제품 교환 어떻게할수있는지 알려주세요	교환문의
개봉한제품 교환 어떻게 할수있는지 알려주세요	교환문의
개봉한 제품 교환 어떻게 할수있는지 알려주세요	교환문의
개봉한제품 교환 어떻게할 수 있는지 알려주세요	교환문의
개봉한 제품 교환 어떻게할 수 있는지 알려주세요	교환문의
개봉한제품 교환 어떻게 할 수 있는지 알려주세요	교환문의
개봉한 제품 교환 어떻게 할 수 있는지 알려주세요	교환문의
저희 지역 영업담당자 번호 확인이 가능할까요?	담당자문의
여기 영업담당자 연락처 좀 알려주세요	담당자문의
저희 영업사원 연락처가 어떻게 되나요?	담당자문의
저희 영업사원 연락처 어떻게 되나요?	담당자문의
영업사원 연락처 알려주세요	담당자문의
영업사원 연락처 확인 가능할까요?	담당자문의
영업사원 연락처 알 수 있을까요?	담당자문의
저희 영업사원 연락처 알 수 있을까요?	담당자문의
저희 영업사원 연락처 알고 싶습니다	담당자문의
영업사원 연락처 알고 싶습니다	담당자문의
영업사원 연락처는 어떻게 알 수 있나요?	담당자문의
영업사원의 연락처는 어떻게 하면 알 수 있나요?	담당자문의
담당자 연락처를 알고 싶습니다 어디에서 확인 가능할까요?	담당자문의
담당자 연락처는 어디서 확인할 수 있나요?	담당자문의
담당자 연락처를 알고 싶습니다 언제 받을 수 있을까요?	담당자문의
담당자 연락처는 언제 받을 수 있을까요?	담당자문의
담당자 연락처 지금 알려주세요	담당자문의
담당자 연락처 바로 알려주세요	담당자문의
영업담당자 연락처 바로 알려주세요	담당자문의
영업담당자 연락처 바로 남겨주세요	담당자문의
영업담당자 핸드폰번호 알려주세요	담당자문의
영업담당자 핸드폰번호 궁금합니다	담당자문의
영업담당자 핸드폰번호 남겨주세요	담당자문의
저희지역 영업담당자번호 알려주세요	담당자문의
저희지역 영업담당자연락처 알려주세요	담당자문의
저희매장 담당자번호알려주세요	담당자문의
저희매장 담당자번호 알려주세요	담당자문의
저희매장 담당자 번호알려주세요	담당자문의
저희 담당 영업사원 연락처를 알고 싶습니다	담당자문의
영업담당자 번호확인 어떻게 해?	담당자문의
영업담당자 번호확인 어떻게 해요?	담당자문의
영업담당자 번호확인 어떻게 하죠?	담당자문의
영업담당자 번호확인 어떻게 합니까?	담당자문의
영업담당자 번호확인 어떻게 하나요?	담당자문의
영업담당자 번호확인 어떻게 할까요?	담당자문의
영업담당자 번호확인 어떻게 해야하죠?	담당자문의
영업담당자 번호확인 어떻게 해야되죠?	담당자문의
영업담당자 번호확인 어떻게 해야돼죠?	담당자문의
영업담당자 번호확인 어떻게 해야하나요?	담당자문의
영업담당자 번호확인 어떻게 해야되나요?	담당자문의
영업담당자 번호확인 어떻게 해야돼나요?	담당자문의
영업담당자 번호확인 어떻게 해야합니까?	담당자문의
영업담당자 번호확인 어떻게 해야하는지 알려주세요	담당자문의
영업담당자 번호확인 어떻게 해야되는지 알려주세요	담당자문의
영업담당자 번호확인 어떻게 해야돼는지 알려주세요	담당자문의
담당자 연락처확인 어떻게 해?	담당자문의
담당자 연락처확인 어떻게 해요?	담당자문의
영업담당자 연락처확인 어떻게 하죠?	담당자문의
영업담당자 연락처확인 어떻게 합니까?	담당자문의
영업담당자 연락처확인 어떻게 하나요?	담당자문의
영업담당자 연락처확인 어떻게 할까요?	담당자문의
영업담당자 연락처확인 어떻게 해야하죠?	담당자문의
영업담당자 연락처확인 어떻게 해야되죠?	담당자문의
영업담당자 연락처확인 어떻게 해야돼죠?	담당자문의
영업담당자 연락처확인 어떻게 해야하나요?	담당자문의
영업담당자 연락처확인 어떻게 해야되나요?	담당자문의
영업담당자 연락처확인 어떻게 해야돼나요?	담당자문의
영업담당자 연락처확인 어떻게 해야합니까?	담당자문의
영업담당자 연락처확인 어떻게 해야하는지 알려주세요	담당자문의
영업담당자 연락처확인 어떻게 해야되는지 알려주세요	담당자문의
영업담당자 연락처확인 어떻게 해야돼는지 알려주세요	담당자문의
저희 영업사원 연락처가 어떻게되나요?	담당자문의
저희 영업사원 연락처 어떻게되나요?	담당자문의
영업사원연락처 알려주세요	담당자문의
영업사원연락처 확인가능할까요?	담당자문의
영업사원 연락처 확인가능할까요?	담당자문의
영업사원연락처 확인 가능할까요?	담당자문의
영업사원연락처 알수있을까요?	담당자문의
영업사원 연락처 알수있을까요?	담당자문의
영업사원연락처 알 수 있을까요?	담당자문의
영업사원 연락처 알 수 있을까요?	담당자문의
저희 영업사원연락처 알수있을까요?	담당자문의
저희 영업사원 연락처 알수있을까요?	담당자문의
저희 영업사원연락처 알 수 있을까요?	담당자문의
저희 영업사원 연락처 알 수 있을까요?	담당자문의
저희 영업사원연락처 알고싶습니다	담당자문의
저희 영업사원 연락처 알고싶습니다	담당자문의
저희 영업사원연락처 알고 싶습니다	담당자문의
저희 영업사원 연락처 알고 싶습니다	담당자문의
영업사원연락처 알고싶습니다	담당자문의
영업사원 연락처 알고싶습니다	담당자문의
영업사원연락처 알고 싶습니다	담당자문의
영업사원연락처는 어떻게 알수있나요?	담당자문의
영업사원 연락처는 어떻게 알수있나요?	담당자문의
영업사원연락처는 어떻게 알 수 있나요?	담당자문의
영업사원 연락처는 어떻게 알 수 있나요?	담당자문의
영업사원의 연락처는 어떻게하면 알수있나요?	담당자문의
영업사원의 연락처는 어떻게 하면 알수있나요?	담당자문의
영업사원의 연락처는 어떻게하면 알 수 있나요?	담당자문의
영업사원의 연락처는 어떻게 하면 알 수 있나요?	담당자문의
담당자연락처를 알고싶습니다 어디에서 확인가능할까요?	담당자문의
담당자 연락처를 알고싶습니다 어디에서 확인가능할까요?	담당자문의
담당자연락처를 알고 싶습니다 어디에서 확인가능할까요?	담당자문의
담당자 연락처를 알고 싶습니다 어디에서 확인가능할까요?	담당자문의
담당자연락처를 알고 싶습니다 어디에서 확인 가능할까요?	담당자문의
담당자 연락처를 알고 싶습니다 어디에서 확인 가능할까요?	담당자문의
담당자연락처는 어디서 확인할수있나요?	담당자문의
담당자 연락처는 어디서 확인할수있나요?	담당자문의
담당자연락처는 어디서 확인할 수 있나요?	담당자문의
담당자 연락처는 어디서 확인할 수 있나요?	담당자문의
담당자연락처를 알고싶습니다 언제 받을수있을까요?	담당자문의
담당자 연락처를 알고싶습니다 언제 받을수있을까요?	담당자문의
담당자연락처를 알고 싶습니다 언제 받을수있을까요?	담당자문의
담당자 연락처를 알고 싶습니다 언제 받을수있을까요?	담당자문의
담당자연락처를 알고 싶습니다 언제 받을 수 있을까요?	담당자문의
담당자 연락처를 알고 싶습니다 언제 받을 수 있을까요?	담당자문의
담당자연락처는 언제 받을수있을까요?	담당자문의
담당자 연락처는 언제 받을수있을까요?	담당자문의
담당자연락처는 언제 받을 수 있을까요?	담당자문의
담당자 연락처는 언제 받을 수 있을까요?	담당자문의
담당처연락처 지금 알려주세요	담당자문의
담당자연락처 바로 알려주세요	담당자문의
영업담당자연락처 바로 알려주세요	담당자문의
영업담당자연락처 바로 남겨주세요	담당자문의
영업담당자핸드폰번호알려주세요	담당자문의
영업담당자 핸드폰번호알려주세요	담당자문의
영업담당자핸드폰번호 알려주세요	담당자문의
영업담당자 핸드폰번호 알려주세요	담당자문의
영업담당자핸드폰번호 궁금합니다	담당자문의
영업담당자핸드폰번호 남겨주세요	담당자문의
저희지역 영업담당자번호알려주세요	담당자문의
저희 지역 영업담당자번호알려주세요	담당자문의
저희지역 영업담당자 번호알려주세요	담당자문의
저희 지역 영업담당자 번호알려주세요	담당자문의
저희지역 영업담당자 번호알려주세요	담당자문의
저희지역 영업담당자번호 알려주세요	담당자문의
저희 지역 영업담당자번호 알려주세요	담당자문의
저희지역 영업담당자연락처알려주세요	담당자문의
저희 지역 영업담당자연락처알려주세요	담당자문의
저희지역 영업담당자 연락처알려주세요	담당자문의
저희 지역 영업담당자 연락처알려주세요	담당자문의
저희지역 영업담당자연락처 알려주세요	담당자문의
저희 지역 영업담당자연락처 알려주세요	담당자문의
저희 매장 담당자번호알려주세요	담당자문의
저희매장 담당자번호 알려주세요	담당자문의
저희 매장 담당자번호 알려주세요	담당자문의
저희담당 영업사원연락처를 알고싶습니다	담당자문의
저희 담당 영업사원연락처를 알고싶습니다	담당자문의
저희담당 영업사원 연락처를 알고싶습니다	담당자문의
저희 담당 영업사원 연락처를 알고싶습니다	담당자문의
저희담당 영업사원 연락처를 알고 싶습니다	담당자문의
저희 담당 영업사원 연락처를 알고 싶습니다	담당자문의
영업담당자번호확인 어떻게해?	담당자문의
영업담당자 번호확인 어떻게해?	담당자문의
영업담당자번호 확인 어떻게해?	담당자문의
영업담당자 번호 확인 어떻게해?	담당자문의
영업담당자번호확인 어떻게 해?	담당자문의
영업담당자 번호확인 어떻게 해?	담당자문의
영업담당자번호 확인 어떻게 해?	담당자문의
영업담당자 번호 확인 어떻게 해?	담당자문의
영업담당자번호확인 어떻게해요?	담당자문의
영업담당자 번호확인 어떻게해요?	담당자문의
영업담당자번호 확인 어떻게해요?	담당자문의
영업담당자 번호 확인 어떻게해요?	담당자문의
영업담당자번호확인 어떻게 해요?	담당자문의
영업담당자 번호확인 어떻게 해요?	담당자문의
영업담당자번호 확인 어떻게 해요?	담당자문의
영업담당자 번호 확인 어떻게 해요?	담당자문의
영업담당자번호확인 어떻게하죠?	담당자문의
영업담당자 번호확인 어떻게하죠?	담당자문의
영업담당자번호 확인 어떻게하죠?	담당자문의
영업담당자 번호 확인 어떻게하죠?	담당자문의
영업담당자번호확인 어떻게 하죠?	담당자문의
영업담당자 번호확인 어떻게 하죠?	담당자문의
영업담당자번호 확인 어떻게 하죠?	담당자문의
영업담당자 번호 확인 어떻게 하죠?	담당자문의
영업담당자번호확인 어떻게합니까?	담당자문의
영업담당자 번호확인 어떻게합니까?	담당자문의
영업담당자번호 확인 어떻게합니까?	담당자문의
영업담당자 번호 확인 어떻게합니까?	담당자문의
영업담당자번호확인 어떻게 합니까?	담당자문의
영업담당자 번호확인 어떻게 합니까?	담당자문의
영업담당자번호 확인 어떻게 합니까?	담당자문의
영업담당자 번호 확인 어떻게 합니까?	담당자문의
영업담당자번호확인 어떻게하나요?	담당자문의
영업담당자 번호확인 어떻게하나요?	담당자문의
영업담당자번호 확인 어떻게하나요?	담당자문의
영업담당자 번호 확인 어떻게하나요?	담당자문의
영업담당자번호확인 어떻게 하나요?	담당자문의
영업담당자 번호확인 어떻게 하나요?	담당자문의
영업담당자번호 확인 어떻게 하나요?	담당자문의
영업담당자 번호 확인 어떻게 하나요?	담당자문의
영업담당자번호확인 어떻게할까요?	담당자문의
영업담당자 번호확인 어떻게할까요?	담당자문의
영업담당자번호 확인 어떻게할까요?	담당자문의
영업담당자 번호 확인 어떻게할까요?	담당자문의
영업담당자번호확인 어떻게 할까요?	담당자문의
영업담당자 번호확인 어떻게 할까요?	담당자문의
영업담당자번호 확인 어떻게 할까요?	담당자문의
영업담당자 번호 확인 어떻게 할까요?	담당자문의
영업담당자번호확인 어떻게해야하죠?	담당자문의
영업담당자 번호확인 어떻게해야하죠?	담당자문의
영업담당자번호 확인 어떻게해야하죠?	담당자문의
영업담당자 번호 확인 어떻게해야하죠?	담당자문의
영업담당자번호확인 어떻게 해야하죠?	담당자문의
영업담당자 번호확인 어떻게 해야하죠?	담당자문의
영업담당자번호 확인 어떻게 해야하죠?	담당자문의
영업담당자 번호 확인 어떻게 해야하죠?	담당자문의
영업담당자번호확인 어떻게해야되죠?	담당자문의
영업담당자 번호확인 어떻게해야되죠?	담당자문의
영업담당자번호 확인 어떻게해야되죠?	담당자문의
영업담당자 번호 확인 어떻게해야되죠?	담당자문의
영업담당자번호확인 어떻게 해야되죠?	담당자문의
영업담당자 번호확인 어떻게 해야되죠?	담당자문의
영업담당자번호 확인 어떻게 해야되죠?	담당자문의
영업담당자 번호 확인 어떻게 해야되죠?	담당자문의
영업담당자번호확인 어떻게해야돼죠?	담당자문의
영업담당자 번호확인 어떻게해야돼죠?	담당자문의
영업담당자번호 확인 어떻게해야돼죠?	담당자문의
영업담당자 번호 확인 어떻게해야돼죠?	담당자문의
영업담당자번호확인 어떻게 해야돼죠?	담당자문의
영업담당자 번호확인 어떻게 해야돼죠?	담당자문의
영업담당자번호 확인 어떻게 해야돼죠?	담당자문의
영업담당자 번호 확인 어떻게 해야돼죠?	담당자문의
영업담당자번호확인 어떻게해야하나요?	담당자문의
영업담당자 번호확인 어떻게해야하나요?	담당자문의
영업담당자번호 확인 어떻게해야하나요?	담당자문의
영업담당자 번호 확인 어떻게해야하나요?	담당자문의
영업담당자번호확인 어떻게 해야하나요?	담당자문의
영업담당자 번호확인 어떻게 해야하나요?	담당자문의
영업담당자번호 확인 어떻게 해야하나요?	담당자문의
영업담당자 번호 확인 어떻게 해야하나요?	담당자문의
영업담당자번호확인 어떻게해야되나요?	담당자문의
영업담당자 번호확인 어떻게해야되나요?	담당자문의
영업담당자번호 확인 어떻게해야되나요?	담당자문의
영업담당자 번호 확인 어떻게해야되나요?	담당자문의
영업담당자번호확인 어떻게 해야되나요?	담당자문의
영업담당자 번호확인 어떻게 해야되나요?	담당자문의
영업담당자번호 확인 어떻게 해야되나요?	담당자문의
영업담당자 번호 확인 어떻게 해야되나요?	담당자문의
영업담당자번호확인 어떻게해야돼나요?	담당자문의
영업담당자 번호확인 어떻게해야돼나요?	담당자문의
영업담당자번호 확인 어떻게해야돼나요?	담당자문의
영업담당자 번호 확인 어떻게해야돼나요?	담당자문의
영업담당자번호확인 어떻게 해야돼나요?	담당자문의
영업담당자 번호확인 어떻게 해야돼나요?	담당자문의
영업담당자번호 확인 어떻게 해야돼나요?	담당자문의
영업담당자 번호 확인 어떻게 해야돼나요?	담당자문의
영업담당자번호확인 어떻게해야합니까?	담당자문의
영업담당자 번호확인 어떻게해야합니까?	담당자문의
영업담당자번호 확인 어떻게해야합니까?	담당자문의
영업담당자 번호 확인 어떻게해야합니까?	담당자문의
영업담당자번호확인 어떻게 해야합니까?	담당자문의
영업담당자 번호확인 어떻게 해야합니까?	담당자문의
영업담당자번호 확인 어떻게 해야합니까?	담당자문의
영업담당자 번호 확인 어떻게 해야합니까?	담당자문의
영업담당자번호확인 어떻게해야하는지알려주세요	담당자문의
영업담당자 번호확인 어떻게해야하는지알려주세요	담당자문의
영업담당자번호 확인 어떻게해야하는지알려주세요	담당자문의
영업담당자 번호 확인 어떻게해야하는지알려주세요	담당자문의
영업담당자번호확인 어떻게 해야하는지알려주세요	담당자문의
영업담당자 번호확인 어떻게 해야하는지알려주세요	담당자문의
영업담당자번호 확인 어떻게 해야하는지알려주세요	담당자문의
영업담당자 번호 확인 어떻게 해야하는지알려주세요	담당자문의
영업담당자번호확인 어떻게 해야하는지 알려주세요	담당자문의
영업담당자 번호확인 어떻게 해야하는지 알려주세요	담당자문의
영업담당자번호 확인 어떻게 해야하는지 알려주세요	담당자문의
영업담당자 번호 확인 어떻게 해야하는지 알려주세요	담당자문의
영업담당자번호확인 어떻게해야되는지알려주세요	담당자문의
영업담당자 번호확인 어떻게해야되는지알려주세요	담당자문의
영업담당자번호 확인 어떻게해야되는지알려주세요	담당자문의
영업담당자 번호 확인 어떻게해야되는지알려주세요	담당자문의
영업담당자번호확인 어떻게 해야되는지알려주세요	담당자문의
영업담당자 번호확인 어떻게 해야되는지알려주세요	담당자문의
영업담당자번호 확인 어떻게 해야되는지알려주세요	담당자문의
영업담당자 번호 확인 어떻게 해야되는지알려주세요	담당자문의
영업담당자번호확인 어떻게 해야되는지 알려주세요	담당자문의
영업담당자 번호확인 어떻게 해야되는지 알려주세요	담당자문의
영업담당자번호 확인 어떻게 해야되는지 알려주세요	담당자문의
영업담당자 번호 확인 어떻게 해야되는지 알려주세요	담당자문의
영업담당자번호확인 어떻게해야돼는지알려주세요	담당자문의
영업담당자 번호확인 어떻게해야돼는지알려주세요	담당자문의
영업담당자번호 확인 어떻게해야돼는지알려주세요	담당자문의
영업담당자 번호 확인 어떻게해야돼는지알려주세요	담당자문의
영업담당자번호확인 어떻게 해야돼는지알려주세요	담당자문의
영업담당자 번호확인 어떻게 해야돼는지알려주세요	담당자문의
영업담당자번호 확인 어떻게 해야돼는지알려주세요	담당자문의
영업담당자 번호 확인 어떻게 해야돼는지알려주세요	담당자문의
영업담당자번호확인 어떻게 해야돼는지 알려주세요	담당자문의
영업담당자 번호확인 어떻게 해야돼는지 알려주세요	담당자문의
영업담당자번호 확인 어떻게 해야돼는지 알려주세요	담당자문의
영업담당자 번호 확인 어떻게 해야돼는지 알려주세요	담당자문의
담당자연락처 확인 어떻게해?	담당자문의
담당자 연락처 확인 어떻게해?	담당자문의
담당자연락처 확인 어떻게 해?	담당자문의
담당자 연락처 확인 어떻게 해?	담당자문의
담당자 연락처확인 어떻게해?	담당자문의
담당자 연락처확인 어떻게 해?	담당자문의
담당자연락처확인 어떻게해요?	담당자문의
담당자 연락처확인 어떻게해요?	담당자문의
담당자연락처 확인 어떻게해요?	담당자문의
담당자 연락처 확인 어떻게해요?	담당자문의
담당자연락처확인 어떻게 해요?	담당자문의
담당자 연락처확인 어떻게 해요?	담당자문의
담당자연락처 확인 어떻게 해요?	담당자문의
담당자 연락처 확인 어떻게 해요?	담당자문의
영업담당자연락처확인 어떻게하죠?	담당자문의
영업 담당자연락처확인 어떻게하죠?	담당자문의
영업담당자 연락처확인 어떻게하죠?	담당자문의
영업담당자연락처 확인 어떻게하죠?	담당자문의
영업담당자연락처확인 어떻게 하죠?	담당자문의
영업 담당자연락처확인 어떻게 하죠?	담당자문의
영업담당자 연락처확인 어떻게 하죠?	담당자문의
영업담당자연락처 확인 어떻게 하죠?	담당자문의
영업담당자연락처확인 어떻게합니까?	담당자문의
영업 담당자연락처확인 어떻게합니까?	담당자문의
영업담당자 연락처확인 어떻게합니까?	담당자문의
영업담당자연락처 확인 어떻게합니까?	담당자문의
영업담당자 연락처 확인 어떻게합니까?	담당자문의
영업담당자연락처확인 어떻게 합니까?	담당자문의
영업 담당자연락처확인 어떻게 합니까?	담당자문의
영업담당자 연락처확인 어떻게 합니까?	담당자문의
영업담당자연락처 확인 어떻게 합니까?	담당자문의
영업담당자 연락처 확인 어떻게 합니까?	담당자문의
영업담당자연락처 확인어떻게하나요?	담당자문의
영업 담당자연락처 확인어떻게하나요?	담당자문의
영업담당자 연락처 확인어떻게하나요?	담당자문의
영업 담당자 연락처 확인어떻게하나요?	담당자문의
영업담당자연락처 확인 어떻게하나요?	담당자문의
영업 담당자연락처 확인 어떻게하나요?	담당자문의
영업담당자 연락처 확인 어떻게하나요?	담당자문의
영업 담당자 연락처 확인 어떻게하나요?	담당자문의
영업담당자연락처 확인 어떻게 하나요?	담당자문의
영업 담당자연락처 확인 어떻게 하나요?	담당자문의
영업담당자 연락처 확인 어떻게 하나요?	담당자문의
영업 담당자 연락처 확인 어떻게 하나요?	담당자문의
영업담당자연락처 확인 어떻게할까요?	담당자문의
영업 담당자연락처 확인 어떻게할까요?	담당자문의
영업담당자 연락처 확인 어떻게할까요?	담당자문의
영업 담당자 연락처 확인 어떻게할까요?	담당자문의
영업담당자연락처 확인 어떻게 할까요?	담당자문의
영업 담당자연락처 확인 어떻게 할까요?	담당자문의
영업담당자 연락처 확인 어떻게 할까요?	담당자문의
영업 담당자 연락처 확인 어떻게 할까요?	담당자문의
영업담당자연락처 확인 어떻게해야하죠?	담당자문의
영업 담당자연락처 확인 어떻게해야하죠?	담당자문의
영업담당자 연락처 확인 어떻게해야하죠?	담당자문의
영업 담당자 연락처 확인 어떻게해야하죠?	담당자문의
영업담당자연락처 확인 어떻게 해야하죠?	담당자문의
영업 담당자연락처 확인 어떻게 해야하죠?	담당자문의
영업담당자 연락처 확인 어떻게 해야하죠?	담당자문의
영업 담당자 연락처 확인 어떻게 해야하죠?	담당자문의
영업담당자연락처 확인 어떻게해야되죠?	담당자문의
영업 담당자연락처 확인 어떻게해야되죠?	담당자문의
영업담당자 연락처 확인 어떻게해야되죠?	담당자문의
영업 담당자 연락처 확인 어떻게해야되죠?	담당자문의
영업담당자연락처 확인 어떻게 해야되죠?	담당자문의
영업 담당자연락처 확인 어떻게 해야되죠?	담당자문의
영업담당자 연락처 확인 어떻게 해야되죠?	담당자문의
영업 담당자 연락처 확인 어떻게 해야되죠?	담당자문의
영업담당자연락처 확인 어떻게해야돼죠?	담당자문의
영업 담당자연락처 확인 어떻게해야돼죠?	담당자문의
영업담당자 연락처 확인 어떻게해야돼죠?	담당자문의
영업 담당자 연락처 확인 어떻게해야돼죠?	담당자문의
영업담당자연락처 확인 어떻게 해야돼죠?	담당자문의
영업 담당자연락처 확인 어떻게 해야돼죠?	담당자문의
영업담당자 연락처 확인 어떻게 해야돼죠?	담당자문의
영업 담당자 연락처 확인 어떻게 해야돼죠?	담당자문의
영업담당자연락처 확인 어떻게해야하나요?	담당자문의
영업 담당자연락처 확인 어떻게해야하나요?	담당자문의
영업담당자 연락처 확인 어떻게해야하나요?	담당자문의
영업 담당자 연락처 확인 어떻게해야하나요?	담당자문의
영업담당자연락처 확인 어떻게 해야하나요?	담당자문의
영업 담당자연락처 확인 어떻게 해야하나요?	담당자문의
영업담당자 연락처 확인 어떻게 해야하나요?	담당자문의
영업 담당자 연락처 확인 어떻게 해야하나요?	담당자문의
영업담당자연락처 확인 어떻게해야되나요?	담당자문의
영업 담당자연락처 확인 어떻게해야되나요?	담당자문의
영업담당자 연락처 확인 어떻게해야되나요?	담당자문의
영업 담당자 연락처 확인 어떻게해야되나요?	담당자문의
영업담당자연락처 확인 어떻게 해야되나요?	담당자문의
영업 담당자연락처 확인 어떻게 해야되나요?	담당자문의
영업담당자 연락처 확인 어떻게 해야되나요?	담당자문의
영업 담당자 연락처 확인 어떻게 해야되나요?	담당자문의
영업담당자연락처 확인 어떻게해야돼나요?	담당자문의
영업 담당자연락처 확인 어떻게해야돼나요?	담당자문의
영업담당자 연락처 확인 어떻게해야돼나요?	담당자문의
영업 담당자 연락처 확인 어떻게해야돼나요?	담당자문의
영업담당자연락처 확인 어떻게 해야돼나요?	담당자문의
영업 담당자연락처 확인 어떻게 해야돼나요?	담당자문의
영업담당자 연락처 확인 어떻게 해야돼나요?	담당자문의
영업 담당자 연락처 확인 어떻게 해야돼나요?	담당자문의
영업담당자연락처 확인 어떻게해야합니까?	담당자문의
영업 담당자연락처 확인 어떻게해야합니까?	담당자문의
영업담당자 연락처 확인 어떻게해야합니까?	담당자문의
영업 담당자 연락처 확인 어떻게해야합니까?	담당자문의
영업담당자연락처 확인 어떻게 해야합니까?	담당자문의
영업 담당자연락처 확인 어떻게 해야합니까?	담당자문의
영업담당자 연락처 확인 어떻게 해야합니까?	담당자문의
영업 담당자 연락처 확인 어떻게 해야합니까?	담당자문의
영업담당자연락처 확인 어떻게해야하는지알려주세요	담당자문의
영업 담당자연락처 확인 어떻게해야하는지알려주세요	담당자문의
영업담당자 연락처 확인 어떻게해야하는지알려주세요	담당자문의
영업 담당자 연락처 확인 어떻게해야하는지알려주세요	담당자문의
영업담당자연락처 확인 어떻게 해야하는지알려주세요	담당자문의
영업 담당자연락처 확인 어떻게 해야하는지알려주세요	담당자문의
영업담당자 연락처 확인 어떻게 해야하는지알려주세요	담당자문의
영업 담당자 연락처 확인 어떻게 해야하는지알려주세요	담당자문의
영업담당자연락처 확인 어떻게 해야하는지 알려주세요	담당자문의
영업 담당자연락처 확인 어떻게 해야하는지 알려주세요	담당자문의
영업담당자 연락처 확인 어떻게 해야하는지 알려주세요	담당자문의
영업 담당자 연락처 확인 어떻게 해야하는지 알려주세요	담당자문의
영업담당자연락처 확인 어떻게 해야되는지알려주세요	담당자문의
영업 담당자연락처 확인 어떻게 해야되는지알려주세요	담당자문의
영업담당자 연락처 확인 어떻게 해야되는지알려주세요	담당자문의
영업 담당자 연락처 확인 어떻게 해야되는지알려주세요	담당자문의
영업담당자연락처 확인 어떻게 해야되는지 알려주세요	담당자문의
영업 담당자연락처 확인 어떻게 해야되는지 알려주세요	담당자문의
영업담당자 연락처 확인 어떻게 해야되는지 알려주세요	담당자문의
영업 담당자 연락처 확인 어떻게 해야되는지 알려주세요	담당자문의
영업담당자연락처 확인 어떻게 해야돼는지알려주세요	담당자문의
영업 담당자연락처 확인 어떻게 해야돼는지알려주세요	담당자문의
영업담당자 연락처 확인 어떻게 해야돼는지알려주세요	담당자문의
영업 담당자 연락처 확인 어떻게 해야돼는지알려주세요	담당자문의
영업담당자연락처 확인 어떻게 해야돼는지 알려주세요	담당자문의
영업 담당자연락처 확인 어떻게 해야돼는지 알려주세요	담당자문의
영업담당자 연락처 확인 어떻게 해야돼는지 알려주세요	담당자문의
영업 담당자 연락처 확인 어떻게 해야돼는지 알려주세요	담당자문의
영업사원과 통화를 하고 싶어요	담당자문의
영업사원하고 통화 연결될까요?	담당자문의
영업사원하고 통화하고 싶어요	담당자문의
영업사원하고 통화 가능할까요?	담당자문의
영업사원하고 통화 연결 부탁드립니다	담당자문의
영업사원하고 전화연결 부탁드립니다	담당자문의
영업사원하고 전화 하고싶어요	담당자문의
영업사원하고 전화연결 가능할까요?	담당자문의
영업사원하고 통화 연결 가능할까요?	담당자문의
담당자랑 통화	담당자문의
영업사원과 통화	담당자문의
영업사원과 통화하려면 어떻게 해야하나요?	담당자문의
영업사원과 통화하고 싶습니다 방법이 있을까요?	담당자문의
영업사원과 통화를 할 수 있을까요?	담당자문의
영업사원과 통화 연결 부탁드립니다	담당자문의
영업사원과 전화 연결 부탁드립니다	담당자문의
영업사원과 전화연결이 가능할까요?	담당자문의
영업사원한테 연락달라고 전달해주세요	담당자문의
영업사원에게 연락달라고 전해주세요	담당자문의
영업사원에게 전화달라고 전해주세요	담당자문의
영업사원에게 전화달라고 전달해주세요	담당자문의
영업사원에게 전화부탁드린다 전해주세요	담당자문의
영업사원에게 전화부탁드린다 전달부탁드립니다	담당자문의
영업사원한테 전화달라고 전달해주세요	담당자문의
영업사원한테 전화 달라고 전달해주세요	담당자문의
영업사원한테 전화 달라고 전달해 주세요	담당자문의
영업사원한테 전화달라고 전달해	담당자문의
영업사원한테 전화 달라고 전달해	담당자문의
영업사원과 통화 어떻게 해?	담당자문의
영업사원과 통화 어떻게 해요?	담당자문의
영업사원과 통화 어떻게 하죠?	담당자문의
영업사원과 통화 어떻게 하나요?	담당자문의
영업사원과 통화 어떻게 할수있죠?	담당자문의
영업사원과 통화 어떻게 할까요?	담당자문의
영업사원과 통화 어떻게 할수있나요?	담당자문의
영업사원과 통화 어떻게 할수있습니까?	담당자문의
영업담당자 통화 어떻게 해?	담당자문의
영업담당자 통화 어떻게 해요?	담당자문의
영업담당자 통화 어떻게 하죠?	담당자문의
영업담당자 통화 어떻게 하나요?	담당자문의
영업담당자 통화 어떻게 할수있죠?	담당자문의
영업담당자 통화 어떻게 할까요?	담당자문의
영업담당자 통화 어떻게 할수있나요?	담당자문의
영업담당자 통화 어떻게 할수있습니까?	담당자문의
영업사원과 전화 어떻게 해?	담당자문의
영업사원과 전화 어떻게 해요?	담당자문의
영업사원과 전화 어떻게 하죠?	담당자문의
영업사원과 전화 어떻게 하나요?	담당자문의
영업사원과 전화 어떻게 할수있죠?	담당자문의
영업사원과 전화 어떻게 할까요?	담당자문의
영업사원과 전화 어떻게 할수있나요?	담당자문의
영업사원과 전화 어떻게 할수있습니까?	담당자문의
영업담당자 전화 어떻게 해?	담당자문의
영업담당자 전화 어떻게 해요?	담당자문의
영업담당자 전화 어떻게 하죠?	담당자문의
영업담당자 전화 어떻게 하나요?	담당자문의
영업담당자 전화 어떻게 할수있죠?	담당자문의
영업담당자 전화 어떻게 할까요?	담당자문의
영업담당자 전화 어떻게 할수있나요?	담당자문의
영업담당자 전화 어떻게 할수있습니까?	담당자문의
영업사원하고 통화연결될까요?	담당자문의
영업사원하고 통화하고싶어요	담당자문의
영업사원하고 통화가능할까요?	담당자문의
영업사원하고 통화연결부탁드립니다	담당자문의
영업사원하고 통화 연결부탁드립니다	담당자문의
영업사원하고 통화연결 부탁드립니다	담당자문의
영업사원하고 통화 연결 부탁드립니다	담당자문의
영업사원하고 전화연결부탁드립니다	담당자문의
영업사원하고 전화 연결부탁드립니다	담당자문의
영업사원하고 전화연결 부탁드립니다	담당자문의
영업사원하고 전화 연결 부탁드립니다	담당자문의
영업사원하고 전화하고싶어요	담당자문의
영업사원하고 전화연결가능할까요?	담당자문의
영업사원하고 전화 연결가능할까요?	담당자문의
영업사원하고 전화연결 가능할까요?	담당자문의
영업사원하고 전화 연결 가능할까요?	담당자문의
영업사원과 통화하고 싶습니다 방법이있을까요?	담당자문의
영업사원과 통화를 할수있을까요?	담당자문의
영업사원과 통화연결부탁드립니다	담당자문의
영업사원과 통화 연결부탁드립니다	담당자문의
영업사원과 통화연결 부탁드립니다	담당자문의
영업사원과 전화연결부탁드립니다	담당자문의
영업사원과 전화 연결부탁드립니다	담당자문의
영업사원과 전화연결 부탁드립니다	담당자문의
영업사원과 전화 연결이 가능할까요?	담당자문의
영업사원한테 연락달라고 전달해 주세요	담당자문의
영업사원에게 전화부탁드린다 전달 부탁드립니다	담당자문의
영업사원과 통화 어떻게해?	담당자문의
영업사원과 통화 어떻게해요?	담당자문의
영업사원과 통화 어떻게하죠?	담당자문의
영업사원과 통화 어떻게하나요?	담당자문의
영업사원과 통화 어떻게할수있죠?	담당자문의
영업사원과 통화 어떻게할까요?	담당자문의
영업사원과 통화 어떻게할수있나요?	담당자문의
영업사원과 통화 어떻게할수있습니까?	담당자문의
영업사원과 통화 어떻게할 수 있습니까?	담당자문의
영업담당자 통화 어떻게해?	담당자문의
영업담당자 통화 어떻게해요?	담당자문의
영업담당자 통화 어떻게하죠?	담당자문의
영업담당자 통화 어떻게하나요?	담당자문의
영업담당자 통화 어떻게할수있죠?	담당자문의
영업담당자 통화 어떻게 할 수 있죠?	담당자문의
영업담당자 통화 어떻게할 수 있죠?	담당자문의
영업담당자 통화 어떻게할까요?	담당자문의
영업담당자 통화 어떻게할수있나요?	담당자문의
영업담당자 통화 어떻게 할 수 있나요?	담당자문의
영업담당자 통화 어떻게할 수 있나요?	담당자문의
영업담당자 통화 어떻게할수있습니까?	담당자문의
영업담당자 통화 어떻게 할 수 있습니까?	담당자문의
영업담당자 통화 어떻게 할 수 있습니까?	담당자문의
영업사원과 전화 어떻게해?	담당자문의
영업사원과 전화 어떻게해요?	담당자문의
영업사원과 전화 어떻게하죠?	담당자문의
영업사원과 전화 어떻게하나요?	담당자문의
영업사원과 전화 어떻게할수있죠?	담당자문의
영업사원과 전화 어떻게 할 수 있죠?	담당자문의
영업사원과 전화 어떻게할까요?	담당자문의
영업사원과 전화 어떻게할 수 있나요?	담당자문의
영업사원과 전화 어떻게 할 수 있나요?	담당자문의
영업사원과 전화 어떻게 할 수 있습니까?	담당자문의
영업담당자 전화 어떻게해?	담당자문의
영업담당자 전화 어떻게해요?	담당자문의
영업담당자 전화 어떻게하죠?	담당자문의
영업담당자 전화 어떻게하나요?	담당자문의
영업담당자 전화 어떻게할수있죠?	담당자문의
영업담당자 전화 어떻게 할 수 있죠?	담당자문의
영업담당자 전화 어떻게할까요?	담당자문의
영업담당자 전화 어떻게할수있나요?	담당자문의
영업담당자 전화 어떻게 할 수 있나요?	담당자문의
영업담당자 전화 어떻게할수있습니까?	담당자문의
영업담당자 전화 어떻게 할 수 있습니까?	담당자문의
영업사원을 매장으로 방문해 달라고 전달해 주세요	담당자문의
영업사원의 매장 방문을 요청합니다	담당자문의
영업사원이 매장으로 방문해 주실 수 있나요?	담당자문의
영업사원이 매장으로 방문해 주실 수 있나요?	담당자문의
매장으로 영업사원방문 가능한가요?	담당자문의
매장으로 영업사원 방문요청드립니다	담당자문의
매장에 영업사원이 방문해주실수있나요?	담당자문의
매장에 영업사원이 방문할수도있나요?	담당자문의
영업사원의 방문 요청 드립니다	담당자문의
영업사원이 매장으로 방문해주세요	담당자문의
영업사원이 어떻게 하면 매장으로 방문할 수 있나요?	담당자문의
영업사원에게 저희 매장으로 방문해달라고 전해주세요	담당자문의
영업사원에게 저희 매장으로 와달라고 전달해주세요	담당자문의
매장으로 영업사원이 방문해 주실 수 있나요?	담당자문의
매장으로 영업사원이 방문해 주셨으면 좋겠어요	담당자문의
매장으로 영업사원이 방문 요청 드리려면 어떻게 해야 하나요?	담당자문의
저희 매장으로 영업사원이 오셔야 할 것 같아요	담당자문의
저희 매장으로 영업담당자가 오셔야 할 것 같아요	담당자문의
저희 매장으로 영업담당자가 와야 할 것 같아요	담당자문의
저희 안경원으로 영업담당자가 와야 할 것 같아요	담당자문의
저희 매장으로 영업담당자가 와야 할 것 같아요	담당자문의
저희매장으로 영업담당자가 와야할것같아요	담당자문의
영업사원을 매장으로 방문해달라고 전달해주세요	담당자문의
영업사원을 매장으로 방문해 달라고 전달해주세요	담당자문의
영업사원을 매장으로 방문해달라고 전달해 주세요	담당자문의
영업담당자를 매장으로 방문해달라고 전달해주세요	담당자문의
영업담당자를 매장으로 방문해달라고 전달해 주세요	담당자문의
영업담당자를 매장으로 방문해 달라고 전달해주세요	담당자문의
영업담당자를 매장으로 방문해 달라고 전달해 주세요	담당자문의
영업담당자 방문요청 어떻게 해?	담당자문의
영업담당자 방문요청 어떻게 해요?	담당자문의
영업담당자 방문요청 어떻게 하죠?	담당자문의
영업담당자 방문요청 어떻게 하나요?	담당자문의
영업담당자 방문요청 어떻게 합니까?	담당자문의
영업담당자 방문요청 어떻게 할수있죠?	담당자문의
영업담당자 방문요청 어떻게 해야하죠?	담당자문의
영업담당자 방문요청 어떻게 해야되죠?	담당자문의
영업담당자 방문요청 어떻게 해야돼죠?	담당자문의
영업담당자 방문요청 어떻게 해야합니까?	담당자문의
영업담당자 방문요청 어떻게 해야하나요?	담당자문의
영업담당자 방문요청 어떻게 할수있나요?	담당자문의
영업담당자 방문요청 어떻게 해야합니까?	담당자문의
영업담당자 방문요청 어떻게 할수있을까요?	담당자문의
영업사원 방문요청 어떻게 해?	담당자문의
영업사원 방문요청 어떻게 해요?	담당자문의
영업사원 방문요청 어떻게 하죠?	담당자문의
영업사원 방문요청 어떻게 하나요?	담당자문의
영업사원 방문요청 어떻게 합니까?	담당자문의
영업사원 방문요청 어떻게 할수있죠?	담당자문의
영업사원 방문요청 어떻게 해야하죠?	담당자문의
영업사원 방문요청 어떻게 해야되죠?	담당자문의
영업사원 방문요청 어떻게 해야돼죠?	담당자문의
영업사원 방문요청 어떻게 해야합니까?	담당자문의
영업사원 방문요청 어떻게 해야하나요?	담당자문의
영업사원 방문요청 어떻게 할수있나요?	담당자문의
영업사원 방문요청 어떻게 해야합니까?	담당자문의
영업사원 방문요청 어떻게 할수있을까요?	담당자문의
영업사원의 매장방문을 요청합니다	담당자문의
영업사원이 매장으로 방문해주실수있나요?	담당자문의
매장으로 영업사원 방문가능한가요?	담당자문의
매장에 영업사원이 방문해 주실 수 있나요?	담당자문의
매장에 영업사원이 방문할 수도 있나요?	담당자문의
영업사원의 방문요청 드립니다	담당자문의
영업사원이 매장으로 방문해 주세요	담당자문의
영업사원이 어떻게하면 매장으로 방문할수있나요?	담당자문의
영업사원이 어떻게 하면 매장으로 방문할수있나요?	담당자문의
영업사원이 어떻게하면 매장으로 방문할 수 있나요?	담당자문의
영업사원이 어떻게 하면 매장으로 방문할 수 있나요?	담당자문의
매장으로 영업사원이 방문해주실수있나요?	담당자문의
매장으로 영업사원이 방문해주셨으면 좋겠어요	담당자문의
매장으로 영업사원이 방문요청드리려면 어떻게 해야하나요?	담당자문의
매장으로 영업사원이 방문 요청드리려면 어떻게 해야하나요?	담당자문의
매장으로 영업사원이 방문요청드리려면 어떻게 해야 하나요?	담당자문의
매장으로 영업사원이 방문 요청드리려면 어떻게 해야 하나요?	담당자문의
저희 매장으로 영업사원이 오셔야할것같아요	담당자문의
저희 매장으로 영업담당자가 오셔야할것같아요	담당자문의
저희 매장으로 영업담당자가 와야할것같아요	담당자문의
저희 안경원으로 영업담당자가 와야할것같아요	담당자문의
영업담당자 방문 요청 어떻게 해?	담당자문의
영업담당자 방문요청 어떻게 해?	담당자문의
영업담당자 방문 요청 어떻게 해요?	담당자문의
영업담당자 방문요청 어떻게 해요?	담당자문의
영업담당자 방문 요청 어떻게 하죠?	담당자문의
영업담당자 방문요청 어떻게 하죠?	담당자문의
영업담당자 방문 요청 어떻게 하나요?	담당자문의
영업담당자 방문요청 어떻게 하나요?	담당자문의
영업담당자 방문 요청 어떻게 합니까?	담당자문의
영업담당자 방문요청 어떻게 합니까?	담당자문의
영업담당자 방문 요청 어떻게 할수있죠?	담당자문의
영업담당자 방문요청 어떻게 할수있죠?	담당자문의
영업담당자 방문 요청 어떻게 해야하죠?	담당자문의
영업담당자 방문요청 어떻게 해야하죠?	담당자문의
영업담당자 방문 요청 어떻게 해야되죠?	담당자문의
영업담당자 방문요청 어떻게 해야되죠?	담당자문의
영업담당자 방문 요청 어떻게 해야돼죠?	담당자문의
영업담당자 방문요청 어떻게 해야돼죠?	담당자문의
영업담당자 방문 요청 어떻게 해야합니까?	담당자문의
영업담당자 방문요청 어떻게 해야합니까?	담당자문의
영업담당자 방문 요청 어떻게 해야하나요?	담당자문의
영업담당자 방문요청 어떻게 해야하나요?	담당자문의
영업담당자 방문 요청 어떻게 할수있나요?	담당자문의
영업담당자 방문요청 어떻게 할수있나요?	담당자문의
영업담당자 방문 요청 어떻게 해야합니까?	담당자문의
영업담당자 방문요청 어떻게 해야합니까?	담당자문의
영업담당자 방문 요청 어떻게 할수있을까요?	담당자문의
영업담당자 방문요청 어떻게 할수있을까요?	담당자문의
영업사원 방문 요청 어떻게 해?	담당자문의
영업사원 방문요청 어떻게해?	담당자문의
영업사원 방문 요청 어떻게 해요?	담당자문의
영업사원 방문요청 어떻게해요?	담당자문의
영업사원 방문 요청 어떻게 하죠?	담당자문의
영업사원 방문요청 어떻게하죠?	담당자문의
영업사원 방문 요청 어떻게 하나요?	담당자문의
영업사원 방문요청 어떻게하나요?	담당자문의
영업사원 방문 요청 어떻게 합니까?	담당자문의
영업사원 방문요청 어떻게합니까?	담당자문의
영업사원 방문 요청 어떻게 할수있죠?	담당자문의
영업사원 방문요청 어떻게할수있죠?	담당자문의
영업사원 방문요청 어떻게 할 수 있죠?	담당자문의
영업사원 방문 요청 어떻게 할 수 있죠?	담당자문의
영업사원 방문 요청 어떻게 해야하죠?	담당자문의
영업사원 방문요청 어떻게해야하죠?	담당자문의
영업사원 방문 요청 어떻게 해야되죠?	담당자문의
영업사원 방문요청 어떻게해야되죠?	담당자문의
영업사원 방문 요청 어떻게 해야돼죠?	담당자문의
영업사원 방문요청 어떻게해야돼죠?	담당자문의
영업사원 방문 요청 어떻게 해야합니까?	담당자문의
영업사원 방문요청 어떻게해야합니까?	담당자문의
영업사원 방문 요청 어떻게 해야하나요?	담당자문의
영업사원 방문요청 어떻게해야하나요?	담당자문의
영업사원 방문 요청 어떻게 할수있나요?	담당자문의
영업사원 방문요청 어떻게할수있나요?	담당자문의
영업사원 방문요청 어떻게 할 수 있나요?	담당자문의
영업사원 방문 요청 어떻게 할 수 있나요?	담당자문의
영업사원 방문 요청 어떻게 해야합니까?	담당자문의
영업사원 방문요청 어떻게해야합니까?	담당자문의
영업사원 방문 요청 어떻게 할수있을까요?	담당자문의
영업사원 방문요청 어떻게할수있을까요?	담당자문의
영업사원 방문요청 어떻게 할 수 있을까요?	담당자문의
영업사원 방문 요청 어떻게 할 수 있을까요?	담당자문의
이번 달 반품 마감일이 언제인가요?	반품문의
이번 달 반품 마감일이 언제 예요?	반품문의
이번 달 반품 마감일 알고 싶습니다	반품문의
반품 마감일 알려주세요	반품문의
반품 마감일 언제 에요?	반품문의
반품 마감일 알려주시면 감사하겠습니다	반품문의
반품 마감일 알려주실수있나요?	반품문의
반품 마감일 확인 부탁드립니다	반품문의
반품 마감일 알려주실수있나요	반품문의
반품 마감일을 어떻게 확인하나요?	반품문의
반품 마감일을 어디서 확인하나요?	반품문의
반품 마감일 확인하는 곳이 있나요?	반품문의
이번달 반품 마감일을 모르는데 확인 부탁드립니다	반품문의
이번달 반품 마감일 확인 부탁드립니다	반품문의
이번달 반품 마감일이 언제인지 알 수 있을까요?	반품문의
이번 달 반품 마감일이 언제인가요?	반품문의
이번 달 반품 마감일 저번 달과 동일한가요?	반품문의
이번 달 반품 마감일 기존과 동일한가요?	반품문의
이번 달 반품 마감일 전과 동일한가요?	반품문의
이번 달 반품 마감일 전화 동일합니까?	반품문의
이번 달 반품 마감일 저번 달과 동일합니까?	반품문의
이번 달 반품 마감일 알려주세요	반품문의
이번 달 반품 마감일 궁금합니다	반품문의
이번 달 반품 마감일 확인 어디서 합니까?	반품문의
이번 달 반품 마감일 어디서 확인 가능합니까?	반품문의
이번 달 반품 마감일 확인이 어디서 가능합니까?	반품문의
이번 달 반품 마감일은 어디서 확인하죠?	반품문의
이번 달 반품 마감일 어디서 확인하죠?	반품문의
이번 달 반품 마감일 어디서 확인할까요?	반품문의
이번 달 반품 마감일은 어디서 확인할까요?	반품문의
반품 마감일은 어디서 확인하죠?	반품문의
반품 마감일 어디서 확인하죠?	반품문의
반품 마감일 어디서 확인합니까?	반품문의
반품 마감일은 어디서 확인합니까?	반품문의
이번 달 반품 마감일 확인 어떻게 해?	반품문의
이번 달 반품 마감일 확인 어떻게 해요?	반품문의
이번 달 반품 마감일 확인 어떻게 하죠?	반품문의
이번 달 반품 마감일 확인 어떻게 합니까?	반품문의
이번 달 반품 마감일 확인 어떻게 하나요?	반품문의
이번 달 반품 마감일 확인 어떻게 해야하죠?	반품문의
이번 달 반품 마감일 확인 어떻게 해야되죠?	반품문의
이번 달 반품 마감일 확인 어떻게 해야돼죠?	반품문의
이번 달 반품 마감일 확인 어떻게 해야하나요?	반품문의
이번 달 반품 마감일 확인 어떻게 해야합니까?	반품문의
이번 달 반품 마감일 확인 어떻게 해야할까요?	반품문의
이번 달 반품 마감일 확인 어떻게 확인하는지 궁금합니다	반품문의
이번 달 반품 마감일 확인 어떻게 가능한지 궁금합니다	반품문의
이번 달 반품 마감일 확인 어떻게 하는지 궁금합니다	반품문의
이번달 반품마감일이 언제인가요?	반품문의
이번 달 반품마감일이 언제인가요?	반품문의
이번달 반품 마감일이 언제인가요?	반품문의
이번 달 반품 마감일이 언제인가요?	반품문의
이번달 반품마감일이 언제예요?	반품문의
이번 달 반품마감일이 언제예요?	반품문의
이번달 반품 마감일이 언제예요?	반품문의
이번 달 반품 마감일이 언제예요?	반품문의
이번달 반품마감일 알고싶습니다	반품문의
이번 달 반품마감일 알고싶습니다	반품문의
이번달 반품 마감일 알고싶습니다	반품문의
이번 달 반품 마감일 알고싶습니다	반품문의
이번달 반품 마감일 알고 싶습니다	반품문의
이번 달 반품 마감일 알고 싶습니다	반품문의
반품마감일알려주세요	반품문의
반품 마감일알려주세요	반품문의
반품마감일 알려주세요	반품문의
반품마감일 언제에요?	반품문의
반품 마감일 언제에요?	반품문의
반품마감일 알려주시면감사하겠습니다	반품문의
반품 마감일 알려주시면감사하겠습니다	반품문의
반품마감일 알려주시면 감사하겠습니다	반품문의
반품 마감일 알려주시면 감사하겠습니다	반품문의
반품마감일 알려주실수있나요?	반품문의
반품마감일 알려주실 수 있나요?	반품문의
반품 마감일 알려주실 수 있나요?	반품문의
반품마감일 확인부탁드립니다	반품문의
반품 마감일 확인부탁드립니다	반품문의
반품마감일 확인 부탁드립니다	반품문의
반품 마감일 확인 부탁드립니다	반품문의
반품마감일 알려주실수있나요	반품문의
반품마감일 알려주실 수 있나요	반품문의
반품 마감일 알려주실 수 있나요	반품문의
반품마감일을 어떻게확인하나요?	반품문의
반품 마감일을 어떻게확인하나요?	반품문의
반품마감일을 어떻게 확인하나요?	반품문의
반품 마감일을 어떻게 확인하나요?	반품문의
반품마감일을 어디서확인하나요?	반품문의
반품 마감일을 어디서확인하나요?	반품문의
반품마감일을 어디서 확인하나요?	반품문의
반품 마감일을 어디서 확인하나요?	반품문의
반품마감일 확인하는곳이 있나요?	반품문의
반품 마감일 확인하는곳이 있나요?	반품문의
반품마감일 확인하는 곳이 있나요?	반품문의
반품 마감일 확인하는 곳이 있나요?	반품문의
이번달 반품마감일을 모르는데 확인부탁드립니다	반품문의
이번 달 반품마감일을 모르는데 확인부탁드립니다	반품문의
이번달 반품 마감일을 모르는데 확인부탁드립니다	반품문의
이번 달 반품 마감일을 모르는데 확인부탁드립니다	반품문의
이번달 반품 마감일을 모르는데 확인 부탁드립니다	반품문의
이번 달 반품 마감일을 모르는데 확인 부탁드립니다	반품문의
이번달 반품마감일 확인부탁드립니다	반품문의
이번 달 반품마감일 확인부탁드립니다	반품문의
이번달 반품 마감일 확인부탁드립니다	반품문의
이번 달 반품 마감일 확인부탁드립니다	반품문의
이번달 반품 마감일 확인 부탁드립니다	반품문의
이번 달 반품 마감일 확인 부탁드립니다	반품문의
이번달 반품마감일이 언제인지 알수있을까요?	반품문의
이번 달 반품마감일이 언제인지 알수있을까요?	반품문의
이번달 반품 마감일이 언제인지 알수있을까요?	반품문의
이번 달 반품 마감일이 언제인지 알수있을까요?	반품문의
이번달 반품 마감일이 언제인지 알 수 있을까요?	반품문의
이번 달 반품 마감일이 언제인지 알 수 있을까요?	반품문의
이번달 반품마감일이 언제인가요?	반품문의
이번 달 반품마감일이 언제인가요?	반품문의
이번달 반품 마감일이 언제인가요?	반품문의
이번 달 반품 마감일이 언제인가요?	반품문의
이번달 반품마감일 저번달과 동일한가요?	반품문의
이번 달 반품마감일 저번달과 동일한가요?	반품문의
이번달 반품 마감일 저번달과 동일한가요?	반품문의
이번 달 반품 마감일 저번달과 동일한가요?	반품문의
이번달 반품 마감일 저번 달과 동일한가요?	반품문의
이번 달 반품 마감일 저번 달과 동일한가요?	반품문의
이번달 반품마감일 기존과 동일한가요?	반품문의
이번 달 반품마감일 기존과 동일한가요?	반품문의
이번달 반품 마감일 기존과 동일한가요?	반품문의
이번 달 반품 마감일 기존과 동일한가요?	반품문의
이번달 반품마감일 전과 동일한가요?	반품문의
이번 달 반품마감일 전과 동일한가요?	반품문의
이번달 반품 마감일 전과 동일한가요?	반품문의
이번 달 반품 마감일 전과 동일한가요?	반품문의
이번달 반품마감일 저번달과 동일합니까?	반품문의
이번 달 반품마감일 저번달과 동일합니까?	반품문의
이번달 반품 마감일 저번달과 동일합니까?	반품문의
이번 달 반품 마감일 저번달과 동일합니까?	반품문의
이번달 반품 마감일 저번 달과 동일합니까?	반품문의
이번 달 반품 마감일 저번 달과 동일합니까?	반품문의
이번달 반품마감일 알려주세요	반품문의
이번 달 반품마감일 알려주세요	반품문의
이번달 반품 마감일 알려주세요	반품문의
이번 달 반품 마감일 알려주세요	반품문의
이번달 반품마감일 궁금합니다	반품문의
이번 달 반품마감일 궁금합니다	반품문의
이번달 반품 마감일 궁금합니다	반품문의
이번 달 반품 마감일 궁금합니다	반품문의
이번달 반품마감일 확인 어디서합니까?	반품문의
이번 달 반품마감일 확인 어디서합니까?	반품문의
이번달 반품 마감일 확인 어디서합니까?	반품문의
이번 달 반품 마감일 확인 어디서합니까?	반품문의
이번달 반품 마감일 확인 어디서 합니까?	반품문의
이번 달 반품 마감일 확인 어디서 합니까?	반품문의
이번달 반품마감일 어디서 확인가능합니까?	반품문의
이번 달 반품마감일 어디서 확인가능합니까?	반품문의
이번달 반품 마감일 어디서 확인가능합니까?	반품문의
이번 달 반품 마감일 어디서 확인가능합니까?	반품문의
이번달 반품 마감일 어디서 확인 가능합니까?	반품문의
이번 달 반품 마감일 어디서 확인 가능합니까?	반품문의
이번달 반품마감일 확인 어디서가능합니까?	반품문의
이번 달 반품마감일 확인 어디서가능합니까?	반품문의
이번달 반품 마감일 확인 어디서가능합니까?	반품문의
이번 달 반품 마감일 확인 어디서가능합니까?	반품문의
이번달 반품 마감일 확인 어디서 가능합니까?	반품문의
이번 달 반품 마감일 확인 어디서 가능합니까?	반품문의
이번달 반품마감일은 어디서 확인하죠?	반품문의
이번 달 반품마감일은 어디서 확인하죠?	반품문의
이번달 반품 마감일은 어디서 확인하죠?	반품문의
이번 달 반품 마감일은 어디서 확인하죠?	반품문의
이번달 반품마감일 어디서 확인하죠?	반품문의
이번 달 반품마감일 어디서 확인하죠?	반품문의
이번달 반품 마감일 어디서 확인하죠?	반품문의
이번 달 반품 마감일 어디서 확인하죠?	반품문의
이번달 반품마감일 어디서 확인할까요?	반품문의
이번 달 반품마감일 어디서 확인할까요?	반품문의
이번달 반품 마감일 어디서 확인할까요?	반품문의
이번 달 반품 마감일 어디서 확인할까요?	반품문의
이번달 반품마감일은 어디서 확인할까요?	반품문의
이번 달 반품마감일은 어디서 확인할까요?	반품문의
이번달 반품 마감일은 어디서 확인할까요?	반품문의
이번 달 반품 마감일은 어디서 확인할까요?	반품문의
반품마감일은 어디서확인하죠?	반품문의
반품 마감일은 어디서확인하죠?	반품문의
반품마감일은 어디서 확인하죠?	반품문의
반품 마감일은 어디서 확인하죠?	반품문의
반품마감일 어디서확인하죠?	반품문의
반품 마감일 어디서확인하죠?	반품문의
반품마감일 어디서 확인하죠?	반품문의
반품 마감일 어디서 확인하죠?	반품문의
반품마감일은 어디서확인합니까?	반품문의
반품 마감일은 어디서확인합니까?	반품문의
반품마감일은 어디서 확인합니까?	반품문의
반품 마감일은 어디서 확인합니까?	반품문의
반품마감일 어디서확인합니까?	반품문의
반품 마감일 어디서확인합니까?	반품문의
반품마감일 어디서 확인합니까?	반품문의
반품 마감일 어디서 확인합니까?	반품문의
이번달 반품마감일 확인 어떻게해?	반품문의
이번 달 반품마감일 확인 어떻게해?	반품문의
이번달 반품 마감일 확인 어떻게해?	반품문의
이번 달 반품 마감일 확인 어떻게해?	반품문의
이번달 반품 마감일 확인 어떻게 해?	반품문의
이번 달 반품 마감일 확인 어떻게 해?	반품문의
이번달 반품마감일 확인 어떻게해요?	반품문의
이번 달 반품마감일 확인 어떻게해요?	반품문의
이번달 반품 마감일 확인 어떻게해요?	반품문의
이번 달 반품 마감일 확인 어떻게해요?	반품문의
이번달 반품 마감일 확인 어떻게 해요?	반품문의
이번 달 반품 마감일 확인 어떻게 해요?	반품문의
이번달 반품마감일 확인 어떻게하죠?	반품문의
이번 달 반품마감일 확인 어떻게하죠?	반품문의
이번달 반품 마감일 확인 어떻게하죠?	반품문의
이번 달 반품 마감일 확인 어떻게하죠?	반품문의
이번달 반품 마감일 확인 어떻게 하죠?	반품문의
이번 달 반품 마감일 확인 어떻게 하죠?	반품문의
이번달 반품마감일 확인 어떻게합니까?	반품문의
이번 달 반품마감일 확인 어떻게합니까?	반품문의
이번달 반품 마감일 확인 어떻게합니까?	반품문의
이번 달 반품 마감일 확인 어떻게합니까?	반품문의
이번달 반품 마감일 확인 어떻게 합니까?	반품문의
이번 달 반품 마감일 확인 어떻게 합니까?	반품문의
이번달 반품마감일 확인 어떻게하나요?	반품문의
이번 달 반품마감일 확인 어떻게하나요?	반품문의
이번달 반품 마감일 확인 어떻게하나요?	반품문의
이번 달 반품 마감일 확인 어떻게하나요?	반품문의
이번달 반품 마감일 확인 어떻게 하나요?	반품문의
이번 달 반품 마감일 확인 어떻게 하나요?	반품문의
이번달 반품마감일 확인 어떻게해야하죠?	반품문의
이번 달 반품마감일 확인 어떻게해야하죠?	반품문의
이번달 반품 마감일 확인 어떻게해야하죠?	반품문의
이번 달 반품 마감일 확인 어떻게해야하죠?	반품문의
이번달 반품 마감일 확인 어떻게 해야하죠?	반품문의
이번 달 반품 마감일 확인 어떻게 해야하죠?	반품문의
이번달 반품마감일 확인 어떻게해야되죠?	반품문의
이번 달 반품마감일 확인 어떻게해야되죠?	반품문의
이번달 반품 마감일 확인 어떻게해야되죠?	반품문의
이번 달 반품 마감일 확인 어떻게해야되죠?	반품문의
이번달 반품 마감일 확인 어떻게 해야되죠?	반품문의
이번 달 반품 마감일 확인 어떻게 해야되죠?	반품문의
이번달 반품마감일 확인 어떻게해야돼죠?	반품문의
이번 달 반품마감일 확인 어떻게해야돼죠?	반품문의
이번달 반품 마감일 확인 어떻게해야돼죠?	반품문의
이번 달 반품 마감일 확인 어떻게해야돼죠?	반품문의
이번달 반품 마감일 확인 어떻게 해야돼죠?	반품문의
이번 달 반품 마감일 확인 어떻게 해야돼죠?	반품문의
이번달 반품마감일 확인 어떻게해야하나요?	반품문의
이번 달 반품마감일 확인 어떻게해야하나요?	반품문의
이번달 반품 마감일 확인 어떻게해야하나요?	반품문의
이번 달 반품 마감일 확인 어떻게해야하나요?	반품문의
이번달 반품 마감일 확인 어떻게 해야하나요?	반품문의
이번 달 반품 마감일 확인 어떻게 해야하나요?	반품문의
이번달 반품마감일 확인 어떻게해야합니까?	반품문의
이번 달 반품마감일 확인 어떻게해야합니까?	반품문의
이번달 반품 마감일 확인 어떻게해야합니까?	반품문의
이번 달 반품 마감일 확인 어떻게해야합니까?	반품문의
이번달 반품 마감일 확인 어떻게 해야합니까?	반품문의
이번 달 반품 마감일 확인 어떻게 해야합니까?	반품문의
이번달 반품마감일 확인 어떻게해야할까요?	반품문의
이번 달 반품마감일 확인 어떻게해야할까요?	반품문의
이번달 반품 마감일 확인 어떻게해야할까요?	반품문의
이번 달 반품 마감일 확인 어떻게해야할까요?	반품문의
이번달 반품 마감일 확인 어떻게 해야할까요?	반품문의
이번 달 반품 마감일 확인 어떻게 해야할까요?	반품문의
이번달 반품마감일 확인 어떻게확인하는지 궁금합니다	반품문의
이번 달 반품마감일 확인 어떻게확인하는지 궁금합니다	반품문의
이번달 반품 마감일 확인 어떻게확인하는지 궁금합니다	반품문의
이번 달 반품 마감일 확인 어떻게확인하는지 궁금합니다	반품문의
이번달 반품 마감일 확인 어떻게 확인하는지 궁금합니다	반품문의
이번 달 반품 마감일 확인 어떻게 확인하는지 궁금합니다	반품문의
이번달 반품마감일 확인 어떻게가능한지 궁금합니다	반품문의
이번 달 반품마감일 확인 어떻게가능한지 궁금합니다	반품문의
이번달 반품 마감일 확인 어떻게가능한지 궁금합니다	반품문의
이번 달 반품 마감일 확인 어떻게가능한지 궁금합니다	반품문의
이번달 반품 마감일 확인 어떻게 가능한지 궁금합니다	반품문의
이번 달 반품 마감일 확인 어떻게 가능한지 궁금합니다	반품문의
이번달 반품마감일 확인 어떻게하는지 궁금합니다	반품문의
이번 달 반품마감일 확인 어떻게하는지 궁금합니다	반품문의
이번달 반품 마감일 확인 어떻게하는지 궁금합니다	반품문의
이번 달 반품 마감일 확인 어떻게하는지 궁금합니다	반품문의
이번달 반품 마감일 확인 어떻게 하는지 궁금합니다	반품문의
이번 달 반품 마감일 확인 어떻게 하는지 궁금합니다	반품문의
반품은 언제 회수해 가나요?	반품문의
반품 회수 언제 되나요?	반품문의
반품 신청했는데 회수 언제 하나요?	반품문의
반품 회수 언제 해요?	반품문의
반품 회수 언제?	반품문의
반품신청했는데 언제 회수해가나요?	반품문의
반품 신청했는데 언제 회수가능한지 알 수 있을까요?	반품문의
반품 회수 신청했습니다 언제 회수되는지 알려주세요	반품문의
반품 회수 신청했는데 언제 회수되나요?	반품문의
반품 회수 언제 되는지 어떻게 알 수 있나요?	반품문의
반품 회수 일정 알려주세요	반품문의
반품 회수 일정 어떻게 확인하나요?	반품문의
반품 회수 일정 알고싶습니다	반품문의
반품 회수 일정 어디에서 확인 가능할까요?	반품문의
반품 회수 일정 확인 후 연락부탁드립니다	반품문의
반품신청한것 회수 언제해가는지 궁금합니다	반품문의
반품 회수 일정이 궁금합니다	반품문의
반품 회수 일정 알려주세요	반품문의
반품 회수 일정 확인해주세요	반품문의
반품 회수 일정 확인부탁드립니다	반품문의
반품 회수 일정 언제인가요?	반품문의
반품은 언제회수해 가나요?	반품문의
반품회수일정이 궁금해요	반품문의
반품회수일정이 궁금합니다	반품문의
반품회수일정이 어떻게되나요?	반품문의
반품회수일정이 어떻게되나요	반품문의
반품회수일정이 어떻게 되나요?	반품문의
반품회수일정은 어디서 확인합니까?	반품문의
반품회수일정 어디서 확인합니까?	반품문의
반품회수일정은 어디에서 확인합니까?	반품문의
반품회수일정 어디에서 확인합니까?	반품문의
반품회수일정 어디서 확인하죠?	반품문의
반품회수일정은 어디서 확인하죠?	반품문의
반품회수일정 어디서 확인해?	반품문의
반품회수일정 어디에서 확인해?	반품문의
반품회수일정은 어디서 확인해?	반품문의
반품회수일정은 어디에서 확인해?	반품문의
반품회수일 언제야?	반품문의
반품회수일 언제에요?	반품문의
반품회수일 언제인가요?	반품문의
반품회수일 언제입니까?	반품문의
반품회수일 언제인지알려주세요	반품문의
반품회수일 언제인지말씀해주세요	반품문의
반품회수일 언제인지 알려주시면 감사합니다	반품문의
반품회수일 언제인지 알려주시면 감사하겠습니다	반품문의
반품회수 언제야?	반품문의
반품회수 언제에요?	반품문의
반품회수 언제인가요?	반품문의
반품회수 언제입니까?	반품문의
반품회수 언제인지알려주세요	반품문의
반품회수 언제인지말씀해주세요	반품문의
반품회수 언제인지 알려주시면 감사합니다	반품문의
반품회수 언제인지 알려주시면 감사하겠습니다	반품문의
반품수거 언제야?	반품문의
반품수거 언제에요?	반품문의
반품수거 언제인가요?	반품문의
반품수거 언제입니까?	반품문의
반품수거 언제인지알려주세요	반품문의
반품수거 언제인지말씀해주세요	반품문의
반품수거 언제인지 알려주시면 감사합니다	반품문의
반품수거 언제인지 알려주시면 감사하겠습니다	반품문의
반품회수 언제되나요?	반품문의
반품 회수 언제되나요?	반품문의
반품회수 언제 되나요?	반품문의
반품신청했는데 회수 언제하나요?	반품문의
반품 신청했는데 회수 언제하나요?	반품문의
반품신청했는데 회수 언제 하나요?	반품문의
반품 신청했는데 회수 언제 하나요?	반품문의
반품회수 언제해요?	반품문의
반품 회수 언제해요?	반품문의
반품회수 언제 해요?	반품문의
반품 회수 언제 해요?	반품문의
반품회수 언제?	반품문의
반품신청했는데 언제 회수가능한지 알수있을까요?	반품문의
반품 신청했는데 언제 회수가능한지 알수있을까요?	반품문의
반품신청했는데 언제 회수가능한지 알 수 있을까요?	반품문의
반품 신청했는데 언제 회수가능한지 알 수 있을까요?	반품문의
반품회수신청했습니다 언제 회수되는지 알려주세요	반품문의
반품 회수신청했습니다 언제 회수되는지 알려주세요	반품문의
반품회수 신청했습니다 언제 회수되는지 알려주세요	반품문의
반품 회수 신청했습니다 언제 회수되는지 알려주세요	반품문의
반품회수신청했는데 언제 회수되나요?	반품문의
반품 회수신청했는데 언제 회수되나요?	반품문의
반품회수 신청했는데 언제 회수되나요?	반품문의
반품 회수 신청했는데 언제 회수되나요?	반품문의
반품회수언제되는지 어떻게 알수있나요?	반품문의
반품 회수언제되는지 어떻게 알수있나요?	반품문의
반품회수 언제되는지 어떻게 알수있나요?	반품문의
반품 회수 언제되는지 어떻게 알수있나요?	반품문의
반품회수언제되는지 어떻게 알 수 있나요?	반품문의
반품 회수언제되는지 어떻게 알 수 있나요?	반품문의
반품회수 언제되는지 어떻게 알 수 있나요?	반품문의
반품 회수 언제되는지 어떻게 알 수 있나요?	반품문의
반품회수일정 알려주세요	반품문의
반품 회수일정 알려주세요	반품문의
반품회수 일정 알려주세요	반품문의
반품 회수 일정 알려주세요	반품문의
반품회수일정 어떻게확인하나요?	반품문의
반품 회수일정 어떻게확인하나요?	반품문의
반품회수 일정 어떻게확인하나요?	반품문의
반품 회수 일정 어떻게확인하나요?	반품문의
반품회수일정 어떻게 확인하나요?	반품문의
반품 회수일정 어떻게 확인하나요?	반품문의
반품회수 일정 어떻게 확인하나요?	반품문의
반품 회수 일정 어떻게 확인하나요?	반품문의
반품회수일정 알고싶습니다	반품문의
반품 회수일정 알고싶습니다	반품문의
반품회수 일정 알고싶습니다	반품문의
반품 회수 일정 알고싶습니다	반품문의
반품회수일정 어디에서 확인가능할까요?	반품문의
반품 회수일정 어디에서 확인가능할까요?	반품문의
반품회수 일정 어디에서 확인가능할까요?	반품문의
반품 회수 일정 어디에서 확인가능할까요?	반품문의
반품회수일정 어디에서 확인 가능할까요?	반품문의
반품 회수일정 어디에서 확인 가능할까요?	반품문의
반품회수 일정 어디에서 확인 가능할까요?	반품문의
반품 회수 일정 어디에서 확인 가능할까요?	반품문의
반품회수일정 확인후 연락부탁드립니다	반품문의
반품 회수일정 확인후 연락부탁드립니다	반품문의
반품회수 일정 확인후 연락부탁드립니다	반품문의
반품 회수 일정 확인후 연락부탁드립니다	반품문의
반품회수일정 확인 후 연락부탁드립니다	반품문의
반품 회수일정 확인 후 연락부탁드립니다	반품문의
반품회수 일정 확인 후 연락부탁드립니다	반품문의
반품 회수 일정 확인 후 연락부탁드립니다	반품문의
반품회수일정 확인 후 연락 부탁드립니다	반품문의
반품 회수일정 확인 후 연락 부탁드립니다	반품문의
반품회수 일정 확인 후 연락 부탁드립니다	반품문의
반품 회수 일정 확인 후 연락 부탁드립니다	반품문의
반품 신청한것 회수 언제해가는지 궁금합니다	반품문의
반품회수일정이 궁금합니다	반품문의
반품 회수일정이 궁금합니다	반품문의
반품회수 일정이 궁금합니다	반품문의
반품 회수 일정이 궁금합니다	반품문의
반품회수일정이 알려주세요	반품문의
반품 회수일정이 알려주세요	반품문의
반품회수 일정이 알려주세요	반품문의
반품 회수 일정이 알려주세요	반품문의
반품회수일정이 확인해주세요	반품문의
반품 회수일정이 확인해주세요	반품문의
반품회수 일정이 확인해주세요	반품문의
반품 회수 일정이 확인해주세요	반품문의
반품회수일정이 확인부탁드립니다	반품문의
반품 회수일정이 확인부탁드립니다	반품문의
반품회수 일정이 확인부탁드립니다	반품문의
반품 회수 일정이 확인부탁드립니다	반품문의
반품회수일정이 확인 부탁드립니다	반품문의
반품 회수일정이 확인 부탁드립니다	반품문의
반품회수 일정이 확인 부탁드립니다	반품문의
반품 회수 일정이 확인 부탁드립니다	반품문의
반품회수일정이 언제 인가요?	반품문의
반품 회수일정이 언제 인가요?	반품문의
반품회수 일정이 언제 인가요?	반품문의
반품 회수 일정이 언제 인가요?	반품문의
반품회수일정이 언제인가요?	반품문의
반품 회수일정이 언제인가요?	반품문의
반품회수 일정이 언제인가요?	반품문의
반품 회수 일정이 언제인가요?	반품문의
반품은 언제 회수해 가나요?	반품문의
반품회수일정이 궁금해요	반품문의
반품 회수일정이 궁금해요	반품문의
반품회수 일정이 궁금해요	반품문의
반품 회수 일정이 궁금해요	반품문의
반품회수일정이 어떻게되나요?	반품문의
반품 회수일정이 어떻게되나요?	반품문의
반품회수 일정이 어떻게되나요?	반품문의
반품 회수 일정이 어떻게되나요?	반품문의
반품회수일정이 어떻게 되나요?	반품문의
반품 회수일정이 어떻게 되나요?	반품문의
반품회수 일정이 어떻게 되나요?	반품문의
반품 회수 일정이 어떻게 되나요?	반품문의
반품회수일정은 어디서 확인합니까?	반품문의
반품 회수일정은 어디서 확인합니까?	반품문의
반품회수 일정은 어디서 확인합니까?	반품문의
반품 회수 일정은 어디서 확인합니까?	반품문의
반품회수일정은 어디서확인합니까?	반품문의
반품 회수일정은 어디서확인합니까?	반품문의
반품회수 일정은 어디서확인합니까?	반품문의
반품 회수 일정은 어디서확인합니까?	반품문의
반품회수일정 어디서 확인합니까?	반품문의
반품 회수일정 어디서 확인합니까?	반품문의
반품회수 일정 어디서 확인합니까?	반품문의
반품 회수 일정 어디서 확인합니까?	반품문의
반품회수일정 어디서확인합니까?	반품문의
반품 회수일정 어디서확인합니까?	반품문의
반품회수 일정 어디서확인합니까?	반품문의
반품 회수 일정 어디서확인합니까?	반품문의
반품회수일정은 어디에서 확인합니까?	반품문의
반품 회수일정은 어디에서 확인합니까?	반품문의
반품회수 일정은 어디에서 확인합니까?	반품문의
반품 회수 일정은 어디에서 확인합니까?	반품문의
반품회수일정은 어디에서확인합니까?	반품문의
반품 회수일정은 어디에서확인합니까?	반품문의
반품회수 일정은 어디에서확인합니까?	반품문의
반품 회수 일정은 어디에서확인합니까?	반품문의
반품회수일정 어디에서 확인합니까?	반품문의
반품 회수일정 어디에서 확인합니까?	반품문의
반품회수 일정 어디에서 확인합니까?	반품문의
반품 회수 일정 어디에서 확인합니까?	반품문의
반품회수일정 어디에서확인합니까?	반품문의
반품 회수일정 어디에서확인합니까?	반품문의
반품회수 일정 어디에서확인합니까?	반품문의
반품 회수 일정 어디에서확인합니까?	반품문의
반품회수일정 어디서 확인하죠?	반품문의
반품 회수일정 어디서 확인하죠?	반품문의
반품회수 일정 어디서 확인하죠?	반품문의
반품 회수 일정 어디서 확인하죠?	반품문의
반품회수일정 어디서확인하죠?	반품문의
반품 회수일정 어디서확인하죠?	반품문의
반품회수 일정 어디서확인하죠?	반품문의
반품 회수 일정 어디서확인하죠?	반품문의
반품회수일정은 어디서 확인하죠?	반품문의
반품 회수일정은 어디서 확인하죠?	반품문의
반품회수 일정은 어디서 확인하죠?	반품문의
반품 회수 일정은 어디서 확인하죠?	반품문의
반품회수일정은 어디서확인하죠?	반품문의
반품 회수일정은 어디서확인하죠?	반품문의
반품회수 일정은 어디서확인하죠?	반품문의
반품 회수 일정은 어디서확인하죠?	반품문의
반품회수일정 어디서 확인해?	반품문의
반품 회수일정 어디서 확인해?	반품문의
반품회수 일정 어디서 확인해?	반품문의
반품 회수 일정 어디서 확인해?	반품문의
반품회수일정 어디서확인해?	반품문의
반품 회수일정 어디서확인해?	반품문의
반품회수 일정 어디서확인해?	반품문의
반품 회수 일정 어디서확인해?	반품문의
반품회수일정 어디서 확인해?	반품문의
반품 회수일정 어디서 확인해?	반품문의
반품회수 일정 어디서 확인해?	반품문의
반품 회수 일정 어디서 확인해?	반품문의
반품회수일정 어디서확인해?	반품문의
반품 회수일정 어디서확인해?	반품문의
반품회수 일정 어디서확인해?	반품문의
반품 회수 일정 어디서확인해?	반품문의
반품회수일정은 어디서 확인해?	반품문의
반품 회수일정은 어디서 확인해?	반품문의
반품회수 일정은 어디서 확인해?	반품문의
반품 회수 일정은 어디서 확인해?	반품문의
반품회수일정은 어디서확인해?	반품문의
반품 회수일정은 어디서확인해?	반품문의
반품회수 일정은 어디서확인해?	반품문의
반품 회수 일정은 어디서확인해?	반품문의
반품회수일정은 어디서 확인해?	반품문의
반품 회수일정은 어디서 확인해?	반품문의
반품회수 일정은 어디서 확인해?	반품문의
반품 회수 일정은 어디서 확인해?	반품문의
반품회수일정은 어디서확인해?	반품문의
반품 회수일정은 어디서확인해?	반품문의
반품회수 일정은 어디서확인해?	반품문의
반품 회수 일정은 어디서확인해?	반품문의
반품 회수일 언제야?	반품문의
반품 회수일 언제에요?	반품문의
반품 회수일 언제인가요?	반품문의
반품 회수일 언제입니까?	반품문의
반품 회수일 언제인지알려주세요	반품문의
반품 회수일 언제인지 알려주세요	반품문의
반품 회수일 언제인지말씀해주세요	반품문의
반품 회수일 언제인지 말씀해주세요	반품문의
반품 회수일 언제인지 알려주시면 감사합니다	반품문의
반품 회수일 언제인지 알려주시면 감사하겠습니다	반품문의
반품 회수 언제야?	반품문의
반품 회수 언제에요?	반품문의
반품 회수 언제인가요?	반품문의
반품 회수 언제입니까?	반품문의
반품 회수 언제인지알려주세요	반품문의
반품 회수 언제인지말씀해주세요	반품문의
반품 회수 언제인지 알려주시면 감사합니다	반품문의
반품 회수 언제인지 알려주시면감사합니다	반품문의
반품 회수 언제인지 알려주시면 감사하겠습니다	반품문의
반품 회수 언제인지 알려주시면감사하겠습니다	반품문의
반품 수거 언제야?	반품문의
반품 수거 언제에요?	반품문의
반품 수거 언제인가요?	반품문의
반품 수거 언제입니까?	반품문의
반품 수거 언제인지알려주세요	반품문의
반품 수거 언제인지말씀해주세요	반품문의
반품 수거 언제인지 알려주시면 감사합니다	반품문의
반품 수거 언제인지 알려주시면감사합니다	반품문의
반품 수거 언제인지 알려주시면 감사하겠습니다	반품문의
반품 수거 언제인지 알려주시면감사하겠습니다	반품문의
반품 대상 품목이 궁금해요	반품문의
반품 가능한 품목이 있나요?	반품문의
반품 가능한 제품이 있나요?	반품문의
반품 가능 제품 알고 싶어요	반품문의
반품 가능한 품목 알려주세요	반품문의
반품이 가능한 제품 알려주세요	반품문의
반품 가능한 제품이 궁금합니다	반품문의
반품 가능한 제품이 어떤건지 알고싶습니다	반품문의
반품 가능한 제품이 어떤게 있는지 알려주세요	반품문의
반품 대상 알려주세요	반품문의
반품 가능 제품 어떻게 확인 가능한가요?	반품문의
반품 가능 제품 확인 부탁드립니다	반품문의
반품 대상 품목 어디에서 확인 할 수 있나요?	반품문의
반품 대상 품목 확인 할 수 있을까요?	반품문의
반품 대상 품목 어떻게 확인 가능할까요?	반품문의
반품 대상 품목인지 궁금한데 어떻게 확인할 수 있을까요?	반품문의
최근 주문한 제품 반품이 가능한가요?	반품문의
최근주문한 제품이 반품 가능한 제품인가요?	반품문의
이 제품이 반품 가능한 제품인가요?	반품문의
반품 가능한 품목이 따로 있나요?	반품문의
반품 가능한 제품이 정해져있나요?	반품문의
반품 가능한 품목이 정해져있나요?	반품문의
반품 가능한 제품이 정해져있습니까?	반품문의
반품 대상 품목이 정해져있습니까?	반품문의
반품 대상 품목이 정해져있나요?	반품문의
반품 대상 품목이 정해져있는지 알려주세요	반품문의
반품 대상 상품이 정해져있나요?	반품문의
반품 대상 상품이 정해져있는지 알려주세요	반품문의
반품 대상 상품이 정해져있을까요?	반품문의
반품 대상 상품이 정해져있는지 궁금합니다	반품문의
반품 대상 상품이 정해져있는지 알고싶습니다	반품문의
반품 대상 상품은 어떻게 확인할 수 있나요?	반품문의
반품 대상 상품은 어떻게 확인 가능할까요?	반품문의
반품 대상 상품은 어떻게 확인 가능합니까?	반품문의
반품 대상 상품은 어떻게 확인 할 수 있습니까?	반품문의
반품 대상 상품은 어떻게 확인 할 수 있는지 궁금합니다	반품문의
반품 대상 상품은 어떻게 확인 해야할까요?	반품문의
반품 대상 상품은 어떻게 확인 할 수 있을까요?	반품문의
반품 대상 제품이 정해져있나요?	반품문의
반품 대상 제품이 정해져있는지 알려주세요	반품문의
반품 대상 제품이 정해져있을까요?	반품문의
반품 대상 제품이 정해져있는지 궁금합니다	반품문의
반품 대상 제품이 정해져있는지 알고싶습니다	반품문의
반품 대상 제품은 어떻게 확인할 수 있나요?	반품문의
반품 대상 제품은 어떻게 확인 가능할까요?	반품문의
반품 대상 제품은 어떻게 확인 가능합니까?	반품문의
반품 대상 제품은 어떻게 확인 할 수 있습니까?	반품문의
반품 대상 제품은 어떻게 확인 할 수 있는지 궁금합니다	반품문의
반품 대상 제품은 어떻게 확인 해야할까요?	반품문의
반품 대상 제품은 어떻게 확인 할 수 있을까요?	반품문의
반품 가능 제품이 정해져있나요?	반품문의
반품 가능 제품이 정해져있는지 알려주세요	반품문의
반품 가능 제품이 정해져있을까요?	반품문의
반품 가능 제품이 정해져있는지 궁금합니다	반품문의
반품 가능 제품이 정해져있는지 알고싶습니다	반품문의
반품 가능 제품은 어떻게 확인할 수 있나요?	반품문의
반품 가능 제품은 어떻게 확인 가능할까요?	반품문의
반품 가능 제품은 어떻게 확인 가능합니까?	반품문의
반품 가능 제품은 어떻게 확인 할 수 있습니까?	반품문의
반품 가능 제품은 어떻게 확인 할 수 있는지 궁금합니다	반품문의
반품 가능 제품은 어떻게 확인 해야할까요?	반품문의
반품 가능 제품은 어떻게 확인 할 수 있을까요?	반품문의
반품 가능 상품이 정해져있나요?	반품문의
반품 가능 상품이 정해져있는지 알려주세요	반품문의
반품 가능 상품이 정해져있을까요?	반품문의
반품 가능 상품이 정해져있는지 궁금합니다	반품문의
반품 가능 상품이 정해져있는지 알고싶습니다	반품문의
반품 가능 상품은 어떻게 확인할 수 있나요?	반품문의
반품 가능 상품은 어떻게 확인 가능할까요?	반품문의
반품 가능 상품은 어떻게 확인 가능합니까?	반품문의
반품 가능 상품은 어떻게 확인 할 수 있습니까?	반품문의
반품 가능 상품은 어떻게 확인 할 수 있는지 궁금합니다	반품문의
반품 가능 상품은 어떻게 확인 해야할까요?	반품문의
반품 가능 상품은 어떻게 확인 할 수 있을까요?	반품문의
반품가능한품목이 있나요?	반품문의
반품 가능한품목이 있나요?	반품문의
반품가능한 품목이 있나요?	반품문의
반품 가능한 품목이 있나요?	반품문의
반품가능한제품이 있나요?	반품문의
반품 가능한제품이 있나요?	반품문의
반품가능한 제품이 있나요?	반품문의
반품 가능한 제품이 있나요?	반품문의
반품가능제품 알고싶어요	반품문의
반품 가능제품 알고싶어요	반품문의
반품가능 제품 알고싶어요	반품문의
반품 가능 제품 알고싶어요	반품문의
반품가능한제품 알려주세요	반품문의
반품 가능한제품 알려주세요	반품문의
반품가능한 제품 알려주세요	반품문의
반품 가능한 제품 알려주세요	반품문의
반품가능한제품이 궁금합니다	반품문의
반품 가능한제품이 궁금합니다	반품문의
반품가능한 제품이 궁금합니다	반품문의
반품 가능한 제품이 궁금합니다	반품문의
반품가능한제품이 어떤건지알고싶습니다	반품문의
반품 가능한제품이 어떤건지알고싶습니다	반품문의
반품가능한 제품이 어떤건지알고싶습니다	반품문의
반품 가능한 제품이 어떤건지알고싶습니다	반품문의
반품가능한제품이 어떤건지 알고싶습니다	반품문의
반품 가능한제품이 어떤건지 알고싶습니다	반품문의
반품가능한 제품이 어떤건지 알고싶습니다	반품문의
반품 가능한 제품이 어떤건지 알고싶습니다	반품문의
반품가능한제품이 어떤게있는지알려주세요	반품문의
반품 가능한제품이 어떤게있는지알려주세요	반품문의
반품가능한 제품이 어떤게있는지알려주세요	반품문의
반품 가능한 제품이 어떤게있는지알려주세요	반품문의
반품가능한제품이 어떤게 있는지알려주세요	반품문의
반품 가능한제품이 어떤게 있는지알려주세요	반품문의
반품가능한 제품이 어떤게 있는지알려주세요	반품문의
반품 가능한 제품이 어떤게 있는지알려주세요	반품문의
반품가능한제품이 어떤게있는지 알려주세요	반품문의
반품 가능한제품이 어떤게있는지 알려주세요	반품문의
반품가능한 제품이 어떤게있는지 알려주세요	반품문의
반품 가능한 제품이 어떤게있는지 알려주세요	반품문의
반품대상알려주세요	반품문의
반품 대상알려주세요	반품문의
반품대상 알려주세요	반품문의
반품가능제품 어떻게 확인가능한가요?	반품문의
반품 가능제품 어떻게 확인가능한가요?	반품문의
반품가능 제품 어떻게 확인가능한가요?	반품문의
반품 가능 제품 어떻게 확인가능한가요?	반품문의
반품가능제품 어떻게 확인 가능한가요?	반품문의
반품 가능제품 어떻게 확인 가능한가요?	반품문의
반품가능 제품 어떻게 확인 가능한가요?	반품문의
반품 가능 제품 어떻게 확인 가능한가요?	반품문의
반품가능제품 확인부탁드립니다	반품문의
반품 가능제품 확인부탁드립니다	반품문의
반품가능 제품 확인부탁드립니다	반품문의
반품 가능 제품 확인부탁드립니다	반품문의
반품가능제품 확인 부탁드립니다	반품문의
반품 가능제품 확인 부탁드립니다	반품문의
반품가능 제품 확인 부탁드립니다	반품문의
반품 가능 제품 확인 부탁드립니다	반품문의
반품대상품목 어디에서 확인할수있나요?	반품문의
반품 대상품목 어디에서 확인할수있나요?	반품문의
반품대상 품목 어디에서 확인할수있나요?	반품문의
반품 대상 품목 어디에서 확인할수있나요?	반품문의
반품대상품목 어디에서 확인 할 수 있나요?	반품문의
반품 대상품목 어디에서 확인 할 수 있나요?	반품문의
반품대상 품목 어디에서 확인 할 수 있나요?	반품문의
반품 대상 품목 어디에서 확인 할 수 있나요?	반품문의
반품대상품목 확인할수일을까요?	반품문의
반품 대상품목 확인할수일을까요?	반품문의
반품대상 품목 확인할수일을까요?	반품문의
반품 대상 품목 확인할수일을까요?	반품문의
반품대상품목 확인할 수 있을까요?	반품문의
반품 대상품목 확인할 수 있을까요?	반품문의
반품대상 품목 확인할 수 있을까요?	반품문의
반품 대상 품목 확인할 수 있을까요?	반품문의
반품대상품목 어떻게 확인가능할까요?	반품문의
반품 대상품목 어떻게 확인가능할까요?	반품문의
반품대상 품목 어떻게 확인가능할까요?	반품문의
반품 대상 품목 어떻게 확인가능할까요?	반품문의
반품대상품목 어떻게 확인 가능할까요?	반품문의
반품 대상품목 어떻게 확인 가능할까요?	반품문의
반품대상 품목 어떻게 확인 가능할까요?	반품문의
반품 대상 품목 어떻게 확인 가능할까요?	반품문의
반품대상품목인지 궁금한데 어떻게 확인할수있을까요?	반품문의
반품 대상품목인지 궁금한데 어떻게 확인할수있을까요?	반품문의
반품대상 품목인지 궁금한데 어떻게 확인할수있을까요?	반품문의
반품 대상 품목인지 궁금한데 어떻게 확인할수있을까요?	반품문의
반품대상품목인지 궁금한데 어떻게 확인할 수 있을까요?	반품문의
반품 대상품목인지 궁금한데 어떻게 확인할 수 있을까요?	반품문의
반품대상 품목인지 궁금한데 어떻게 확인할 수 있을까요?	반품문의
반품 대상 품목인지 궁금한데 어떻게 확인할 수 있을까요?	반품문의
최근 주문한제품 반품이 가능한가요?	반품문의
이 제품이 반품가능한제품인가요?	반품문의
이 제품이 반품 가능한제품인가요?	반품문의
이 제품이 반품가능한 제품인가요?	반품문의
반품가능한품목이 따로 있나요?	반품문의
반품 가능한품목이 따로 있나요?	반품문의
반품가능한 품목이 따로 있나요?	반품문의
반품가능한제품이 정해져있나요?	반품문의
반품 가능한제품이 정해져있나요?	반품문의
반품가능한 제품이 정해져있나요?	반품문의
반품가능한제품이 정해져 있나요?	반품문의
반품 가능한제품이 정해져 있나요?	반품문의
반품가능한 제품이 정해져 있나요?	반품문의
반품가능한품목이 정해져있나요?	반품문의
반품 가능한품목이 정해져있나요?	반품문의
반품가능한 품목이 정해져있나요?	반품문의
반품가능한품목이 정해져 있나요?	반품문의
반품 가능한품목이 정해져 있나요?	반품문의
반품가능한 품목이 정해져 있나요?	반품문의
반품가능한제품이 정해져있습니까?	반품문의
반품 가능한제품이 정해져있습니까?	반품문의
반품가능한 제품이 정해져있습니까?	반품문의
반품가능한제품이 정해져 있습니까?	반품문의
반품 가능한제품이 정해져 있습니까?	반품문의
반품가능한 제품이 정해져 있습니까?	반품문의
반품대상품목이 정해져있습니까?	반품문의
반품 대상품목이 정해져있습니까?	반품문의
반품대상 품목이 정해져있습니까?	반품문의
반품대상품목이 정해져 있습니까?	반품문의
반품 대상품목이 정해져 있습니까?	반품문의
반품대상 품목이 정해져 있습니까?	반품문의
반품대상품목이 정해져있나요?	반품문의
반품 대상품목이 정해져있나요?	반품문의
반품대상 품목이 정해져있나요?	반품문의
반품대상품목이 정해져 있나요?	반품문의
반품 대상품목이 정해져 있나요?	반품문의
반품대상 품목이 정해져 있나요?	반품문의
반품대상품목이 정해져있는지 알려주세요	반품문의
반품 대상품목이 정해져있는지 알려주세요	반품문의
반품대상 품목이 정해져있는지 알려주세요	반품문의
반품대상품목이 정해져 있는지 알려주세요	반품문의
반품 대상품목이 정해져 있는지 알려주세요	반품문의
반품대상 품목이 정해져 있는지 알려주세요	반품문의
반품대상품목이 정해져있나요?	반품문의
반품 대상품목이 정해져있나요?	반품문의
반품대상 품목이 정해져있나요?	반품문의
반품대상품목이 정해져 있나요?	반품문의
반품 대상품목이 정해져 있나요?	반품문의
반품대상 품목이 정해져 있나요?	반품문의
반품대상품목이 정해져있는지 알려주세요	반품문의
반품 대상품목이 정해져있는지 알려주세요	반품문의
반품대상 품목이 정해져있는지 알려주세요	반품문의
반품대상품목이 정해져 있는지 알려주세요	반품문의
반품 대상품목이 정해져 있는지 알려주세요	반품문의
반품대상 품목이 정해져 있는지 알려주세요	반품문의
반품대상품목이 정해져있을까요?	반품문의
반품 대상품목이 정해져있을까요?	반품문의
반품대상 품목이 정해져있을까요?	반품문의
반품대상품목이 정해져 있을까요?	반품문의
반품 대상품목이 정해져 있을까요?	반품문의
반품대상 품목이 정해져 있을까요?	반품문의
반품대상품목이 정해져있는지궁금합니다	반품문의
반품 대상품목이 정해져있는지궁금합니다	반품문의
반품대상 품목이 정해져있는지궁금합니다	반품문의
반품대상품목이 정해져 있는지궁금합니다	반품문의
반품 대상품목이 정해져 있는지궁금합니다	반품문의
반품대상 품목이 정해져 있는지궁금합니다	반품문의
반품대상품목이 정해져있는지알고싶습니다	반품문의
반품 대상품목이 정해져있는지알고싶습니다	반품문의
반품대상 품목이 정해져있는지알고싶습니다	반품문의
반품대상품목이 정해져 있는지알고싶습니다	반품문의
반품 대상품목이 정해져 있는지알고싶습니다	반품문의
반품대상 품목이 정해져 있는지알고싶습니다	반품문의
반품대상상품은 어떻게 확인할수있나요?	반품문의
반품 대상상품은 어떻게 확인할수있나요?	반품문의
반품대상 상품은 어떻게 확인할수있나요?	반품문의
반품대상상품은 어떻게 확인할 수 있나요?	반품문의
반품 대상상품은 어떻게 확인할 수 있나요?	반품문의
반품대상 상품은 어떻게 확인할 수 있나요?	반품문의
반품대상상품은 어떻게 확인가능할까요?	반품문의
반품 대상상품은 어떻게 확인가능할까요?	반품문의
반품대상 상품은 어떻게 확인가능할까요?	반품문의
반품대상상품은 어떻게 확인 가능할까요?	반품문의
반품 대상상품은 어떻게 확인 가능할까요?	반품문의
반품대상 상품은 어떻게 확인 가능할까요?	반품문의
반품대상상품은 어떻게 확인가능합니까?	반품문의
반품 대상상품은 어떻게 확인가능합니까?	반품문의
반품대상 상품은 어떻게 확인가능합니까?	반품문의
반품대상상품은 어떻게 확인 가능합니까?	반품문의
반품 대상상품은 어떻게 확인 가능합니까?	반품문의
반품대상 상품은 어떻게 확인 가능합니까?	반품문의
반품대상상품은 어떻게 확인할수있습니까?	반품문의
반품 대상상품은 어떻게 확인할수있습니까?	반품문의
반품대상 상품은 어떻게 확인할수있습니까?	반품문의
반품대상상품은 어떻게 확인할 수 있습니까?	반품문의
반품 대상상품은 어떻게 확인할 수 있습니까?	반품문의
반품대상 상품은 어떻게 확인할 수 있습니까?	반품문의
반품대상상품은 어떻게 확인할수있는지궁금합니다	반품문의
반품 대상상품은 어떻게 확인할수있는지궁금합니다	반품문의
반품대상 상품은 어떻게 확인할수있는지궁금합니다	반품문의
반품대상상품은 어떻게 확인할 수 있는지궁금합니다	반품문의
반품 대상상품은 어떻게 확인할 수 있는지궁금합니다	반품문의
반품대상 상품은 어떻게 확인할 수 있는지궁금합니다	반품문의
반품대상상품은 어떻게 확인할 수 있는지 궁금합니다	반품문의
반품 대상상품은 어떻게 확인할 수 있는지 궁금합니다	반품문의
반품대상 상품은 어떻게 확인할 수 있는지 궁금합니다	반품문의
반품대상상품은 어떻게 확인해야할까요?	반품문의
반품 대상상품은 어떻게 확인해야할까요?	반품문의
반품대상 상품은 어떻게 확인해야할까요?	반품문의
반품대상상품은 어떻게 확인해야 할까요?	반품문의
반품 대상상품은 어떻게 확인해야 할까요?	반품문의
반품대상 상품은 어떻게 확인해야 할까요?	반품문의
반품대상상품은 어떻게 확인할수있을까요?	반품문의
반품 대상상품은 어떻게 확인할수있을까요?	반품문의
반품대상 상품은 어떻게 확인할수있을까요?	반품문의
반품대상상품은 어떻게 확인할 수 있을까요?	반품문의
반품 대상상품은 어떻게 확인할 수 있을까요?	반품문의
반품대상 상품은 어떻게 확인할 수 있을까요?	반품문의
반품 대상제품이 정해져있나요?	반품문의
반품대상 제품이 정해져있나요?	반품문의
반품 대상 제품이 정해져있나요?	반품문의
반품 대상제품이 정해져 있나요?	반품문의
반품대상 제품이 정해져 있나요?	반품문의
반품 대상 제품이 정해져 있나요?	반품문의
반품 대상제품이 정해져있는지알려주세요?	반품문의
반품대상 제품이 정해져있는지알려주세요?	반품문의
반품 대상 제품이 정해져있는지알려주세요?	반품문의
반품 대상제품이 정해져있는지 알려주세요?	반품문의
반품대상 제품이 정해져있는지 알려주세요?	반품문의
반품 대상 제품이 정해져있는지 알려주세요?	반품문의
반품 대상제품이 정해져있을까요?	반품문의
반품대상 제품이 정해져있을까요?	반품문의
반품 대상 제품이 정해져있을까요?	반품문의
반품 대상제품이 정해져있는지궁금합니다	반품문의
반품대상 제품이 정해져있는지궁금합니다	반품문의
반품 대상 제품이 정해져있는지궁금합니다	반품문의
반품 대상제품이 정해져 있는지궁금합니다	반품문의
반품대상 제품이 정해져 있는지궁금합니다	반품문의
반품 대상 제품이 정해져 있는지궁금합니다	반품문의
반품 대상제품이 정해져알고싶습니다	반품문의
반품대상 제품이 정해져알고싶습니다	반품문의
반품 대상 제품이 정해져알고싶습니다	반품문의
반품대상제품은 어떻게 확인할수있나요?	반품문의
반품 대상제품은 어떻게 확인할수있나요?	반품문의
반품대상 제품은 어떻게 확인할수있나요?	반품문의
반품대상제품은 어떻게 확인할 수 있나요?	반품문의
반품 대상제품은 어떻게 확인할 수 있나요?	반품문의
반품대상 제품은 어떻게 확인할 수 있나요?	반품문의
반품대상제품은 어떻게 확인가능할까요?	반품문의
반품 대상제품은 어떻게 확인가능할까요?	반품문의
반품대상 제품은 어떻게 확인가능할까요?	반품문의
반품대상제품은 어떻게 확인 가능할까요?	반품문의
반품 대상제품은 어떻게 확인 가능할까요?	반품문의
반품대상 제품은 어떻게 확인 가능할까요?	반품문의
반품대상제품은 어떻게 확인가능합니까?	반품문의
반품 대상제품은 어떻게 확인가능합니까?	반품문의
반품대상 제품은 어떻게 확인가능합니까?	반품문의
반품대상제품은 어떻게 확인 가능합니까?	반품문의
반품 대상제품은 어떻게 확인 가능합니까?	반품문의
반품대상 제품은 어떻게 확인 가능합니까?	반품문의
반품대상제품은 어떻게 확인할수있습니까?	반품문의
반품 대상제품은 어떻게 확인할수있습니까?	반품문의
반품대상 제품은 어떻게 확인할수있습니까?	반품문의
반품대상제품은 어떻게 확인할 수 있습니까?	반품문의
반품 대상제품은 어떻게 확인할 수 있습니까?	반품문의
반품대상 제품은 어떻게 확인할 수 있습니까?	반품문의
반품대상제품은 어떻게 확인할수있는지궁금합니다	반품문의
반품 대상제품은 어떻게 확인할수있는지궁금합니다	반품문의
반품대상 제품은 어떻게 확인할수있는지궁금합니다	반품문의
반품대상제품은 어떻게 확인할 수 있는지궁금합니다	반품문의
반품 대상제품은 어떻게 확인할 수 있는지궁금합니다	반품문의
반품대상 제품은 어떻게 확인할 수 있는지궁금합니다	반품문의
반품대상제품은 어떻게 확인할 수 있는지 궁금합니다	반품문의
반품 대상제품은 어떻게 확인할 수 있는지 궁금합니다	반품문의
반품대상 제품은 어떻게 확인할 수 있는지 궁금합니다	반품문의
반품대상제품은 어떻게 확인해야할까요?	반품문의
반품 대상제품은 어떻게 확인해야할까요?	반품문의
반품대상 제품은 어떻게 확인해야할까요?	반품문의
반품대상제품은 어떻게 확인해야 할까요?	반품문의
반품 대상제품은 어떻게 확인해야 할까요?	반품문의
반품대상 제품은 어떻게 확인해야 할까요?	반품문의
반품대상제품은 어떻게 확인할수있을까요?	반품문의
반품 대상제품은 어떻게 확인할수있을까요?	반품문의
반품대상 제품은 어떻게 확인할수있을까요?	반품문의
반품대상제품은 어떻게 확인할 수 있을까요?	반품문의
반품 대상제품은 어떻게 확인할 수 있을까요?	반품문의
반품대상 제품은 어떻게 확인할 수 있을까요?	반품문의
반품 가능제품이 정해져있나요?	반품문의
반품가능 제품이 정해져있나요?	반품문의
반품 가능 제품이 정해져있나요?	반품문의
반품 가능제품이 정해져 있나요?	반품문의
반품가능 제품이 정해져 있나요?	반품문의
반품 가능 제품이 정해져 있나요?	반품문의
반품 가능제품이 정해져있는지알려주세요	반품문의
반품가능 제품이 정해져있는지알려주세요	반품문의
반품 가능 제품이 정해져있는지알려주세요	반품문의
반품 가능제품이 정해져있는지 알려주세요	반품문의
반품가능 제품이 정해져있는지 알려주세요	반품문의
반품 가능 제품이 정해져있는지 알려주세요	반품문의
반품 가능제품이 정해져있을까요?	반품문의
반품가능 제품이 정해져있을까요?	반품문의
반품 가능 제품이 정해져있을까요?	반품문의
반품 가능제품이 정해져있는지궁금합니다	반품문의
반품가능 제품이 정해져있는지궁금합니다	반품문의
반품 가능 제품이 정해져있는지궁금합니다	반품문의
반품 가능제품이 정해져 있는지궁금합니다	반품문의
반품가능 제품이 정해져 있는지궁금합니다	반품문의
반품 가능 제품이 정해져 있는지궁금합니다	반품문의
반품 가능제품이 정해져알고싶습니다	반품문의
반품가능 제품이 정해져알고싶습니다	반품문의
반품 가능 제품이 정해져알고싶습니다	반품문의
반품가능제품은 어떻게 확인할수있나요?	반품문의
반품 가능제품은 어떻게 확인할수있나요?	반품문의
반품가능 제품은 어떻게 확인할수있나요?	반품문의
반품가능제품은 어떻게 확인할 수 있나요?	반품문의
반품 가능제품은 어떻게 확인할 수 있나요?	반품문의
반품가능 제품은 어떻게 확인할 수 있나요?	반품문의
반품가능제품은 어떻게 확인가능합까요?	반품문의
반품 가능제품은 어떻게 확인가능합까요?	반품문의
반품가능 제품은 어떻게 확인가능합까요?	반품문의
반품가능제품은 어떻게 확인 가능합까요?	반품문의
반품 가능제품은 어떻게 확인 가능합까요?	반품문의
반품가능 제품은 어떻게 확인 가능합까요?	반품문의
반품가능제품은 어떻게 확인가능합니까?	반품문의
반품 가능제품은 어떻게 확인가능합니까?	반품문의
반품가능 제품은 어떻게 확인가능합니까?	반품문의
반품가능제품은 어떻게 확인 가능합니까?	반품문의
반품 가능제품은 어떻게 확인 가능합니까?	반품문의
반품가능 제품은 어떻게 확인 가능합니까?	반품문의
반품가능제품은 어떻게 확인할수있습니까?	반품문의
반품 가능제품은 어떻게 확인할수있습니까?	반품문의
반품가능 제품은 어떻게 확인할수있습니까?	반품문의
반품가능제품은 어떻게 확인할 수 있습니까?	반품문의
반품 가능제품은 어떻게 확인할 수 있습니까?	반품문의
반품가능 제품은 어떻게 확인할 수 있습니까?	반품문의
반품가능제품은 어떻게 확인할수있는지궁금합니다	반품문의
반품 가능제품은 어떻게 확인할수있는지궁금합니다	반품문의
반품가능 제품은 어떻게 확인할수있는지궁금합니다	반품문의
반품가능제품은 어떻게 확인할 수 있는지궁금합니다	반품문의
반품 가능제품은 어떻게 확인할 수 있는지궁금합니다	반품문의
반품가능 제품은 어떻게 확인할 수 있는지궁금합니다	반품문의
반품가능제품은 어떻게 확인할 수 있는지 궁금합니다	반품문의
반품 가능제품은 어떻게 확인할 수 있는지 궁금합니다	반품문의
반품가능 제품은 어떻게 확인할 수 있는지 궁금합니다	반품문의
반품가능제품은 어떻게 확인해야할까요?	반품문의
반품 가능제품은 어떻게 확인해야할까요?	반품문의
반품가능 제품은 어떻게 확인해야할까요?	반품문의
반품가능제품은 어떻게 확인해야 할까요?	반품문의
반품 가능제품은 어떻게 확인해야 할까요?	반품문의
반품가능 제품은 어떻게 확인해야 할까요?	반품문의
반품가능제품은 어떻게 확인할수있을까요?	반품문의
반품 가능제품은 어떻게 확인할수있을까요?	반품문의
반품가능 제품은 어떻게 확인할수있을까요?	반품문의
반품가능제품은 어떻게 확인할 수 있을까요?	반품문의
반품 가능제품은 어떻게 확인할 수 있을까요?	반품문의
반품가능 제품은 어떻게 확인할 수 있을까요?	반품문의
반품 가능상품이 정해져있나요?	반품문의
반품가능 상품이 정해져있나요?	반품문의
반품 가능 상품이 정해져있나요?	반품문의
반품 가능상품이 정해져 있나요?	반품문의
반품가능 상품이 정해져 있나요?	반품문의
반품 가능 상품이 정해져 있나요?	반품문의
반품 가능상품이 정해져있는지알려주세요	반품문의
반품가능 상품이 정해져있는지알려주세요	반품문의
반품 가능 상품이 정해져있는지알려주세요	반품문의
반품 가능상품이 정해져있는지 알려주세요	반품문의
반품가능 상품이 정해져있는지 알려주세요	반품문의
반품 가능 상품이 정해져있는지 알려주세요	반품문의
반품 가능상품이 정해져있을까요?	반품문의
반품가능 상품이 정해져있을까요?	반품문의
반품 가능 상품이 정해져있을까요?	반품문의
반품 가능상품이 정해져있는지궁금합니다	반품문의
반품가능 상품이 정해져있는지궁금합니다	반품문의
반품 가능 상품이 정해져있는지궁금합니다	반품문의
반품 가능상품이 정해져 있는지궁금합니다	반품문의
반품가능 상품이 정해져 있는지궁금합니다	반품문의
반품 가능 상품이 정해져 있는지궁금합니다	반품문의
반품 가능상품이 정해져알고싶습니다	반품문의
반품가능 상품이 정해져알고싶습니다	반품문의
반품 가능 상품이 정해져알고싶습니다	반품문의
반품가능상품은 어떻게 확인할수있나요?	반품문의
반품 가능상품은 어떻게 확인할수있나요?	반품문의
반품가능 상품은 어떻게 확인할수있나요?	반품문의
반품가능상품은 어떻게 확인할 수 있나요?	반품문의
반품 가능상품은 어떻게 확인할 수 있나요?	반품문의
반품가능 상품은 어떻게 확인할 수 있나요?	반품문의
반품가능상품은 어떻게 확인가능합까요?	반품문의
반품 가능상품은 어떻게 확인가능합까요?	반품문의
반품가능 상품은 어떻게 확인가능합까요?	반품문의
반품가능상품은 어떻게 확인 가능합까요?	반품문의
반품 가능상품은 어떻게 확인 가능합까요?	반품문의
반품가능 상품은 어떻게 확인 가능합까요?	반품문의
반품가능상품은 어떻게 확인가능합니까?	반품문의
반품 가능상품은 어떻게 확인가능합니까?	반품문의
반품가능 상품은 어떻게 확인가능합니까?	반품문의
반품가능상품은 어떻게 확인 가능합니까?	반품문의
반품 가능상품은 어떻게 확인 가능합니까?	반품문의
반품가능 상품은 어떻게 확인 가능합니까?	반품문의
반품가능상품은 어떻게 확인할수있습니까?	반품문의
반품 가능상품은 어떻게 확인할수있습니까?	반품문의
반품가능 상품은 어떻게 확인할수있습니까?	반품문의
반품가능상품은 어떻게 확인할 수 있습니까?	반품문의
반품 가능상품은 어떻게 확인할 수 있습니까?	반품문의
반품가능 상품은 어떻게 확인할 수 있습니까?	반품문의
반품가능상품은 어떻게 확인할수있는지궁금합니다	반품문의
반품 가능상품은 어떻게 확인할수있는지궁금합니다	반품문의
반품가능 상품은 어떻게 확인할수있는지궁금합니다	반품문의
반품가능상품은 어떻게 확인할 수 있는지궁금합니다	반품문의
반품 가능상품은 어떻게 확인할 수 있는지궁금합니다	반품문의
반품가능 상품은 어떻게 확인할 수 있는지궁금합니다	반품문의
반품가능상품은 어떻게 확인할 수 있는지 궁금합니다	반품문의
반품 가능상품은 어떻게 확인할 수 있는지 궁금합니다	반품문의
반품가능 상품은 어떻게 확인할 수 있는지 궁금합니다	반품문의
반품가능상품은 어떻게 확인해야할까요?	반품문의
반품 가능상품은 어떻게 확인해야할까요?	반품문의
반품가능 상품은 어떻게 확인해야할까요?	반품문의
반품가능상품은 어떻게 확인해야 할까요?	반품문의
반품 가능상품은 어떻게 확인해야 할까요?	반품문의
반품가능 상품은 어떻게 확인해야 할까요?	반품문의
반품가능상품은 어떻게 확인할수있을까요?	반품문의
반품 가능상품은 어떻게 확인할수있을까요?	반품문의
반품가능 상품은 어떻게 확인할수있을까요?	반품문의
반품가능상품은 어떻게 확인할 수 있을까요?	반품문의
반품 가능상품은 어떻게 확인할 수 있을까요?	반품문의
반품가능 상품은 어떻게 확인할 수 있을까요?	반품문의
반품 내역을 조회할 수 있나요?	반품문의
반품 내역 조회해주세요	반품문의
반품 내역 조회 부탁드립니다	반품문의
반품 내역 조회 어디서해요?	반품문의
반품 내역 조회 하고싶어요	반품문의
반품 내역 조회해주세요	반품문의
반품 내역 궁금해요	반품문의
반품 내역 조회 어디서 할 수 있나요?	반품문의
반품 어디서 조회 할 수 있어요?	반품문의
반품 어디서 조회가능한가요?	반품문의
반품 내역 조회하고싶어요	반품문의
반품 내역 조회 어디서 할 수 있나요?	반품문의
반품 내역 조회 부탁드려요	반품문의
반품 내역 조회 어떻게 확인 할 수 있나요?	반품문의
반품 내역 조회 어디에서 확인할 수 있나요?	반품문의
반품 내역 조회 어떻게 확인해야 할까요?	반품문의
반품 신청 내역 알려주세요	반품문의
반품 신청 내역 확인 어디서 해요?	반품문의
반품 신청 내역 확인 어디서 할 수 있나요?	반품문의
반품 신청 내역 확인해주세요	반품문의
반품 신청 내역 확인됩니까?	반품문의
반품 신청 내역 확인하는 법 알려주세요	반품문의
반품 신청 내역 확인하는 방법 알려주세요	반품문의
반품신청 내역 보는방법 알려주세요	반품문의
반품신청 내역 보는법 알려주세요	반품문의
반품신청 내역 보는방법 알수있을까요?	반품문의
반품신청내역 보는법 알수있을까요?	반품문의
반품신청내역은 어디서 확인해?	반품문의
반품신청내역 어디서 확인해?	반품문의
반품신청내역 어디서 확인해요?	반품문의
반품신청내역은 어디서 확인해요?	반품문의
반품신청내역은 어디서 확인합니까?	반품문의
반품신청내역 어디서 확인합니까?	반품문의
반품내역조회 어떻게 확인해?	반품문의
반품내역조회 어떻게 확인하죠?	반품문의
반품내역조회 어떻게 확인해요?	반품문의
반품내역조회 어떻게 확인하나요?	반품문의
반품내역조회 어떻게 확인할까요?	반품문의
반품내역조회 어떻게 확인할수있죠?	반품문의
반품내역조회 어떻게 확인가능하죠?	반품문의
반품내역조회 어떻게 확인할수있나요?	반품문의
반품내역조회 어떻게 확인할수있는지 알려주세요	반품문의
반품내역을 조회할수있나요?	반품문의
반품 내역을 조회할수있나요?	반품문의
반품내역을 조회할 수 있나요?	반품문의
반품내역 조회해주세요	반품문의
반품 내역 조회해주세요	반품문의
반품내역 조회해 주세요	반품문의
반품 내역 조회해 주세요	반품문의
반품내역 조회부탁드립니다	반품문의
반품 내역 조회부탁드립니다	반품문의
반품내역 조회 부탁드립니다	반품문의
반품 내역 조회 부탁드립니다	반품문의
반품내역 조회어디서해요?	반품문의
반품 내역 조회어디서해요?	반품문의
반품내역 조회 어디서해요?	반품문의
반품 내역 조회 어디서해요?	반품문의
반품내역 조회어디서 해요?	반품문의
반품 내역 조회어디서 해요?	반품문의
반품내역 조회 어디서 해요?	반품문의
반품 내역 조회 어디서 해요?	반품문의
반품내역 조회하고싶어요	반품문의
반품 내역 조회하고싶어요	반품문의
반품내역 조회 하고싶어요	반품문의
반품 내역 조회 하고싶어요	반품문의
반품내역 궁금해요	반품문의
반품 내역 궁금해요	반품문의
반품내역조회 어디서 할수있나요?	반품문의
반품 내역조회 어디서 할수있나요?	반품문의
반품내역 조회 어디서 할수있나요?	반품문의
반품 내역 조회 어디서 할수있나요?	반품문의
반품내역조회 어디서 할 수 있나요?	반품문의
반품 내역조회 어디서 할 수 있나요?	반품문의
반품내역 조회 어디서 할 수 있나요?	반품문의
반품 내역 조회 어디서 할 수 있나요?	반품문의
반품 어디서 조회할수있어요?	반품문의
반품 어디서 조회가능한가요?	반품문의
반품내역조회하고싶어요	반품문의
반품내역 조회부탁드려요	반품문의
반품 내역 조회부탁드려요	반품문의
반품내역 조회 부탁드려요	반품문의
반품 내역 조회 부탁드려요	반품문의
반품내역조회 어떻게 할수있나요?	반품문의
반품 내역조회 어떻게 할수있나요?	반품문의
반품내역 조회 어떻게 할수있나요?	반품문의
반품 내역 조회 어떻게 할수있나요?	반품문의
반품내역조회 어떻게 할 수 있나요?	반품문의
반품 내역조회 어떻게 할 수 있나요?	반품문의
반품내역 조회 어떻게 할 수 있나요?	반품문의
반품 내역 조회 어떻게 할 수 있나요?	반품문의
반품내역조회 어디에서 할수있나요?	반품문의
반품 내역조회 어디에서 할수있나요?	반품문의
반품내역 조회 어디에서 할수있나요?	반품문의
반품 내역 조회 어디에서 할수있나요?	반품문의
반품내역조회 어디에서 할 수 있나요?	반품문의
반품 내역조회 어디에서 할 수 있나요?	반품문의
반품내역 조회 어디에서 할 수 있나요?	반품문의
반품 내역 조회 어디에서 할 수 있나요?	반품문의
반품내역조회 어떻게 확인해야할까요?	반품문의
반품 내역조회 어떻게 확인해야할까요?	반품문의
반품내역 조회 어떻게 확인해야할까요?	반품문의
반품 내역 조회 어떻게 확인해야할까요?	반품문의
반품내역조회 어떻게 확인해야 할까요?	반품문의
반품 내역조회 어떻게 확인해야 할까요?	반품문의
반품내역 조회 어떻게 확인해야 할까요?	반품문의
반품 내역 조회 어떻게 확인해야 할까요?	반품문의
반품신청내역 확인 어디서해요?	반품문의
반품 신청내역 확인 어디서해요?	반품문의
반품신청 내역 확인 어디서해요?	반품문의
반품 신청 내역 확인 어디서해요?	반품문의
반품신청내역 확인 어디서 해요?	반품문의
반품 신청내역 확인 어디서 해요?	반품문의
반품신청 내역 확인 어디서 해요?	반품문의
반품 신청 내역 확인 어디서 해요?	반품문의
반품신청내역 확인 어디서할수있나요?	반품문의
반품 신청내역 확인 어디서할수있나요?	반품문의
반품신청 내역 확인 어디서할수있나요?	반품문의
반품 신청 내역 확인 어디서할수있나요?	반품문의
반품신청내역 확인 어디서 할수있나요?	반품문의
반품 신청내역 확인 어디서 할수있나요?	반품문의
반품신청 내역 확인 어디서 할수있나요?	반품문의
반품 신청 내역 확인 어디서 할수있나요?	반품문의
반품신청내역 확인 어디서 할 수 있나요?	반품문의
반품 신청내역 확인 어디서 할 수 있나요?	반품문의
반품신청 내역 확인 어디서 할 수 있나요?	반품문의
반품 신청 내역 확인 어디서 할 수 있나요?	반품문의
반품신청내역 확인해주세요	반품문의
반품 신청내역 확인해주세요	반품문의
반품신청 내역 확인해주세요	반품문의
반품 신청 내역 확인해주세요	반품문의
반품신청내역 확인해 주세요	반품문의
반품 신청내역 확인해 주세요	반품문의
반품신청 내역 확인해 주세요	반품문의
반품 신청 내역 확인해 주세요	반품문의
반품신청내역 확인 확인됩니까?	반품문의
반품 신청내역 확인 확인됩니까?	반품문의
반품신청 내역 확인 확인됩니까?	반품문의
반품 신청 내역 확인 확인됩니까?	반품문의
반품신청내역 확인 확인 됩니까?	반품문의
반품 신청내역 확인 확인 됩니까?	반품문의
반품신청 내역 확인 확인 됩니까?	반품문의
반품 신청 내역 확인 확인 됩니까?	반품문의
반품신청내역 확인하는법알려주세요	반품문의
반품 신청내역 확인하는법알려주세요	반품문의
반품신청 내역 확인하는법알려주세요	반품문의
반품 신청 내역 확인하는법알려주세요	반품문의
반품신청내역 확인하는법 알려주세요	반품문의
반품 신청내역 확인하는법 알려주세요	반품문의
반품신청 내역 확인하는법 알려주세요	반품문의
반품 신청 내역 확인하는법 알려주세요	반품문의
반품신청내역 확인 하는법 알려주세요	반품문의
반품 신청내역 확인 하는법 알려주세요	반품문의
반품신청 내역 확인 하는법 알려주세요	반품문의
반품 신청 내역 확인 하는법 알려주세요	반품문의
반품신청내역 확인하는방법알려주세요	반품문의
반품 신청내역 확인하는방법알려주세요	반품문의
반품신청 내역 확인하는방법알려주세요	반품문의
반품 신청 내역 확인하는방법알려주세요	반품문의
반품신청내역 확인하는방법 알려주세요	반품문의
반품 신청내역 확인하는방법 알려주세요	반품문의
반품신청 내역 확인하는방법 알려주세요	반품문의
반품 신청 내역 확인하는방법 알려주세요	반품문의
반품신청내역 확인 하는방법 알려주세요	반품문의
반품 신청내역 확인 하는방법 알려주세요	반품문의
반품신청 내역 확인 하는방법 알려주세요	반품문의
반품 신청 내역 확인 하는방법 알려주세요	반품문의
반품신청내역 보는방법알려주세요	반품문의
반품 신청내역 보는방법알려주세요	반품문의
반품신청 내역 보는방법알려주세요	반품문의
반품 신청 내역 보는방법알려주세요	반품문의
반품신청내역 보는 방법알려주세요	반품문의
반품 신청내역 보는 방법알려주세요	반품문의
반품신청 내역 보는 방법알려주세요	반품문의
반품 신청 내역 보는 방법알려주세요	반품문의
반품신청내역 보는방법 알려주세요	반품문의
반품 신청내역 보는방법 알려주세요	반품문의
반품신청 내역 보는방법 알려주세요	반품문의
반품 신청 내역 보는방법 알려주세요	반품문의
반품신청내역 보는법알려주세요	반품문의
반품 신청내역 보는법알려주세요	반품문의
반품신청 내역 보는법알려주세요	반품문의
반품 신청 내역 보는법알려주세요	반품문의
반품신청내역 보는 법알려주세요	반품문의
반품 신청내역 보는 법알려주세요	반품문의
반품신청 내역 보는 법알려주세요	반품문의
반품 신청 내역 보는 법알려주세요	반품문의
반품신청내역 보는법 알려주세요	반품문의
반품 신청내역 보는법 알려주세요	반품문의
반품신청 내역 보는법 알려주세요	반품문의
반품 신청 내역 보는법 알려주세요	반품문의
반품신청내역 보는방법알수있을까요?	반품문의
반품 신청내역 보는방법알수있을까요?	반품문의
반품신청 내역 보는방법알수있을까요?	반품문의
반품 신청 내역 보는방법알수있을까요?	반품문의
반품신청내역 보는방법 알 수 있을까요?	반품문의
반품 신청내역 보는방법 알 수 있을까요?	반품문의
반품신청 내역 보는방법 알 수 있을까요?	반품문의
반품 신청 내역 보는방법 알 수 있을까요?	반품문의
반품신청내역 보는 방법 알 수 있을까요?	반품문의
반품 신청내역 보는 방법 알 수 있을까요?	반품문의
반품신청 내역 보는 방법 알 수 있을까요?	반품문의
반품 신청 내역 보는 방법 알 수 있을까요?	반품문의
반품신청내역 보는법알수있을까요?	반품문의
반품 신청내역 보는법알수있을까요?	반품문의
반품신청 내역 보는법알수있을까요?	반품문의
반품 신청 내역 보는법알수있을까요?	반품문의
반품신청내역 보는법 알 수 있을까요?	반품문의
반품 신청내역 보는법 알 수 있을까요?	반품문의
반품신청 내역 보는법 알 수 있을까요?	반품문의
반품 신청 내역 보는법 알 수 있을까요?	반품문의
반품신청내역 보는 법 알 수 있을까요?	반품문의
반품 신청내역 보는 법 알 수 있을까요?	반품문의
반품신청 내역 보는 법 알 수 있을까요?	반품문의
반품 신청 내역 보는 법 알 수 있을까요?	반품문의
반품신청내역은 어디서 확인해?	반품문의
반품 신청내역은 어디서 확인해?	반품문의
반품신청 내역은 어디서 확인해?	반품문의
반품 신청 내역은 어디서 확인해?	반품문의
반품신청내역은 어디서 확인 해?	반품문의
반품 신청내역은 어디서 확인 해?	반품문의
반품신청 내역은 어디서 확인 해?	반품문의
반품 신청 내역은 어디서 확인 해?	반품문의
반품신청내역 어디서 확인해?	반품문의
반품 신청내역 어디서 확인해?	반품문의
반품신청 내역 어디서 확인해?	반품문의
반품 신청 내역 어디서 확인해?	반품문의
반품신청내역 어디서 확인 해?	반품문의
반품 신청내역 어디서 확인 해?	반품문의
반품신청 내역 어디서 확인 해?	반품문의
반품 신청 내역 어디서 확인 해?	반품문의
반품신청내역 어디서 확인해요?	반품문의
반품 신청내역 어디서 확인해요?	반품문의
반품신청 내역 어디서 확인해요?	반품문의
반품 신청 내역 어디서 확인해요?	반품문의
반품신청내역 어디서 확인 해요?	반품문의
반품 신청내역 어디서 확인 해요?	반품문의
반품신청 내역 어디서 확인 해요?	반품문의
반품 신청 내역 어디서 확인 해요?	반품문의
반품신청내역은 어디서 확인해요?	반품문의
반품 신청내역은 어디서 확인해요?	반품문의
반품신청 내역은 어디서 확인해요?	반품문의
반품 신청 내역은 어디서 확인해요?	반품문의
반품신청내역은 어디서 확인 해요?	반품문의
반품 신청내역은 어디서 확인 해요?	반품문의
반품신청 내역은 어디서 확인 해요?	반품문의
반품 신청 내역은 어디서 확인 해요?	반품문의
반품신청내역은 어디서 확인합니까?	반품문의
반품 신청내역은 어디서 확인합니까?	반품문의
반품신청 내역은 어디서 확인합니까?	반품문의
반품 신청 내역은 어디서 확인합니까?	반품문의
반품신청내역은 어디서 확인 합니까?	반품문의
반품 신청내역은 어디서 확인 합니까?	반품문의
반품신청 내역은 어디서 확인 합니까?	반품문의
반품 신청 내역은 어디서 확인 합니까?	반품문의
반품신청내역 어디서 확인합니까?	반품문의
반품 신청내역 어디서 확인합니까?	반품문의
반품신청 내역 어디서 확인합니까?	반품문의
반품 신청 내역 어디서 확인합니까?	반품문의
반품신청내역 어디서 확인 합니까?	반품문의
반품 신청내역 어디서 확인 합니까?	반품문의
반품신청 내역 어디서 확인 합니까?	반품문의
반품 신청 내역 어디서 확인 합니까?	반품문의
반품내역조회 어떻게 확인해?	반품문의
반품 내역조회 어떻게 확인해?	반품문의
반품내역 조회 어떻게 확인해?	반품문의
반품 내역 조회 어떻게 확인해?	반품문의
반품내역조회 어떻게 확인 해?	반품문의
반품 내역조회 어떻게 확인 해?	반품문의
반품내역 조회 어떻게 확인 해?	반품문의
반품 내역 조회 어떻게 확인 해?	반품문의
반품내역조회 어떻게 확인하죠?	반품문의
반품 내역조회 어떻게 확인하죠?	반품문의
반품내역 조회 어떻게 확인하죠?	반품문의
반품 내역 조회 어떻게 확인하죠?	반품문의
반품내역조회 어떻게 확인 하죠?	반품문의
반품 내역조회 어떻게 확인 하죠?	반품문의
반품내역 조회 어떻게 확인 하죠?	반품문의
반품 내역 조회 어떻게 확인 하죠?	반품문의
반품내역조회 어떻게 확인해요?	반품문의
반품 내역조회 어떻게 확인해요?	반품문의
반품내역 조회 어떻게 확인해요?	반품문의
반품 내역 조회 어떻게 확인해요?	반품문의
반품내역조회 어떻게 확인 해요?	반품문의
반품 내역조회 어떻게 확인 해요?	반품문의
반품내역 조회 어떻게 확인 해요?	반품문의
반품 내역 조회 어떻게 확인 해요?	반품문의
반품내역조회 어떻게 확인하나요?	반품문의
반품 내역조회 어떻게 확인하나요?	반품문의
반품내역 조회 어떻게 확인하나요?	반품문의
반품 내역 조회 어떻게 확인하나요?	반품문의
반품내역조회 어떻게 확인 하나요?	반품문의
반품 내역조회 어떻게 확인 하나요?	반품문의
반품내역 조회 어떻게 확인 하나요?	반품문의
반품 내역 조회 어떻게 확인 하나요?	반품문의
반품내역조회 어떻게 확인할까요?	반품문의
반품 내역조회 어떻게 확인할까요?	반품문의
반품내역 조회 어떻게 확인할까요?	반품문의
반품 내역 조회 어떻게 확인할까요?	반품문의
반품내역조회 어떻게 확인 할까요?	반품문의
반품 내역조회 어떻게 확인 할까요?	반품문의
반품내역 조회 어떻게 확인 할까요?	반품문의
반품 내역 조회 어떻게 확인 할까요?	반품문의
반품내역조회 어떻게 확인할수있죠?	반품문의
반품 내역조회 어떻게 확인할수있죠?	반품문의
반품내역 조회 어떻게 확인할수있죠?	반품문의
반품 내역 조회 어떻게 확인할수있죠?	반품문의
반품내역조회 어떻게 확인 할 수 있죠?	반품문의
반품내역조회 어떻게 확인 할 수 있죠?	반품문의
반품 내역조회 어떻게 확인 할 수 있죠?	반품문의
반품내역 조회 어떻게 확인 할 수 있죠?	반품문의
반품 내역 조회 어떻게 확인 할 수 있죠?	반품문의
반품내역조회 어떻게 확인가능하죠?	반품문의
반품 내역조회 어떻게 확인가능하죠?	반품문의
반품내역 조회 어떻게 확인가능하죠?	반품문의
반품 내역 조회 어떻게 확인가능하죠?	반품문의
반품내역조회 어떻게 확인 가능하죠?	반품문의
반품 내역조회 어떻게 확인 가능하죠?	반품문의
반품내역 조회 어떻게 확인 가능하죠?	반품문의
반품 내역 조회 어떻게 확인 가능하죠?	반품문의
반품내역조회 어떻게 확인할수있나요?	반품문의
반품 내역조회 어떻게 확인할수있나요?	반품문의
반품내역 조회 어떻게 확인할수있나요?	반품문의
반품 내역 조회 어떻게 확인할수있나요?	반품문의
반품내역조회 어떻게 확인 할 수 있나요?	반품문의
반품내역조회 어떻게 확인 할 수 있나요?	반품문의
반품 내역조회 어떻게 확인 할 수 있나요?	반품문의
반품내역 조회 어떻게 확인 할 수 있나요?	반품문의
반품 내역 조회 어떻게 확인 할 수 있나요?	반품문의
반품내역조회 어떻게 확인할수있는지알려주세요	반품문의
반품 내역조회 어떻게 확인할수있는지알려주세요	반품문의
반품내역 조회 어떻게 확인할수있는지알려주세요	반품문의
반품 내역 조회 어떻게 확인할수있는지알려주세요	반품문의
반품내역조회 어떻게 확인할 수 있는지알려주세요	반품문의
반품 내역조회 어떻게 확인할 수 있는지알려주세요	반품문의
반품내역 조회 어떻게 확인할 수 있는지알려주세요	반품문의
반품 내역 조회 어떻게 확인할 수 있는지알려주세요	반품문의
반품내역조회 어떻게 확인할 수 있는지 알려주세요	반품문의
반품 내역조회 어떻게 확인할 수 있는지 알려주세요	반품문의
반품내역 조회 어떻게 확인할 수 있는지 알려주세요	반품문의
반품 내역 조회 어떻게 확인할 수 있는지 알려주세요	반품문의
반품 금액이 어떻게 되나요?	반품문의
반품 금액 확인 부탁드립니다	반품문의
반품 금액이 궁금해요	반품문의
반품 금액이 얼마인지 궁금합니다	반품문의
반품 금액이 얼마인가요?	반품문의
반품 금액이 얼마인지 확인 부탁드립니다	반품문의
반품 금액이 얼마일지 궁금합니다	반품문의
반품 금액이 어떻게 되는지 궁금합니다	반품문의
반품 금액이 어떻게 되는지 알려주세요	반품문의
반품 금액 어떻게 되는지 확인 부탁드립니다	반품문의
반품 금액 얼마인지 알려주세요	반품문의
반품 금액 얼마인가요? 궁금합니다	반품문의
반품 금액 확인해주세요	반품문의
반품 금액 어떻게 확인 할 수 있을까요?	반품문의
반품 금액 확인 어디에서 할 수 있나요?	반품문의
반품 금액 확인하고 싶어요 어디서 확인해야하나요?	반품문의
환불 금액 확인해주세요	반품문의
환불 금액 알려주세요	반품문의
환불 금액이 어떻게 되나요?	반품문의
환불 금액 확인 어디서 해요?	반품문의
환불 금액 확인 어디서 합니까?	반품문의
환불 금액 알고싶습니다	반품문의
환불 금액 어디서 확인 가능한가요?	반품문의
환불 금액 어떻게 확인 할 수 있나요?	반품문의
환불 금액 어떻게 확인해야 할까요?	반품문의
반품 금액 얼마인지 확인 어디서 합니까?	반품문의
반품 금액 얼마인지 확인 어떻게 합니까?	반품문의
반품 금액 어떻게 확인해야합니까?	반품문의
반품 금액 어떻게 확인할 수 있나요?	반품문의
반품금액은 어디서 확인해?	반품문의
반품금액 어디서 확인해?	반품문의
반품금액은 어디서 확인해요?	반품문의
반품금액 어디서 확인해요?	반품문의
반품금액 어디에서 확인해요?	반품문의
반품금액은 어디에서 확인해요?	반품문의
반품금액 어디에서 확인해?	반품문의
반품금액은 어디에서 확인해?	반품문의
반품금액은 어디에서 확인합니까?	반품문의
반품금액 어디에서 확인합니까?	반품문의
환불 금액 얼마인지 확인 어디서 합니까?	반품문의
환불 금액 얼마인지 확인 어떻게 합니까?	반품문의
환불 금액 어떻게 확인해야합니까?	반품문의
환불 금액 어떻게 확인할 수 있나요?	반품문의
환불금액은 어디서 확인해?	반품문의
환불금액은 어디서 확인해요?	반품문의
환불금액은 어디에서 확인해요?	반품문의
환불금액은 어디에서 확인합니까?	반품문의
환불금액 어디서 확인해?	반품문의
환불금액 어디서 확인해요?	반품문의
환불금액 어디에서 확인해요?	반품문의
환불금액 어디에서 확인합니까?	반품문의
반품금액이 어떻게되나요?	반품문의
반품 금액이 어떻게되나요?	반품문의
반품금액이 어떻게 되나요?	반품문의
반품금액 확인부탁드립니다	반품문의
반품 금액 확인부탁드립니다	반품문의
반품금액 확인 부탁드립니다	반품문의
반품 금액 확인 부탁드립니다	반품문의
반품금액이 궁금해요	반품문의
반품금액이 얼마인지궁금합니다	반품문의
반품 금액이 얼마인지궁금합니다	반품문의
반품금액이 얼마인지 궁금합니다	반품문의
반품금액이 얼마인가요?	반품문의
반품 금액이 얼마인가요?	반품문의
반품금액이 얼마 인가요?	반품문의
반품 금액이 얼마 인가요?	반품문의
반품금액이 얼마인지 확인부탁드립니다	반품문의
반품 금액이 얼마인지 확인부탁드립니다	반품문의
반품금액이 얼마인지 확인 부탁드립니다	반품문의
반품 금액이 얼마인지 확인 부탁드립니다	반품문의
반품금액이 얼마일지궁금합니다	반품문의
반품 금액이 얼마일지궁금합니다	반품문의
반품금액이 얼마일지 궁금합니다	반품문의
반품 금액이 얼마일지 궁금합니다	반품문의
반품금액이 어떻게되는지궁금합니다	반품문의
반품 금액이 어떻게되는지궁금합니다	반품문의
반품금액이 어떻게 되는지궁금합니다	반품문의
반품 금액이 어떻게 되는지궁금합니다	반품문의
반품금액이 어떻게되는지 궁금합니다	반품문의
반품 금액이 어떻게되는지 궁금합니다	반품문의
반품금액이 어떻게되는지알려주세요	반품문의
반품 금액이 어떻게되는지알려주세요	반품문의
반품금액이 어떻게 되는지알려주세요	반품문의
반품 금액이 어떻게 되는지알려주세요	반품문의
반품금액이 어떻게되는지 알려주세요	반품문의
반품 금액이 어떻게되는지 알려주세요	반품문의
반품금액 어떻게되는지 확인부탁드립니다	반품문의
반품 금액 어떻게되는지 확인부탁드립니다	반품문의
반품금액 어떻게 되는지 확인부탁드립니다	반품문의
반품 금액 어떻게 되는지 확인부탁드립니다	반품문의
반품금액 어떻게 되는지 확인 부탁드립니다	반품문의
반품 금액 어떻게 되는지 확인 부탁드립니다	반품문의
반품금액 얼마인지알려주세요	반품문의
반품 금액 얼마인지알려주세요	반품문의
반품금액 얼마인지 알려주세요	반품문의
반품 금액 얼마인지 알려주세요	반품문의
반품금액 얼마인가요? 궁금합니다	반품문의
반품 금액 얼마인가요? 궁금합니다	반품문의
반품금액 얼마인가요? 궁금합니다	반품문의
반품금액 확인해주세요	반품문의
반품 금액 확인해주세요	반품문의
반품금액 확인 해주세요	반품문의
반품 금액 확인 해주세요	반품문의
반품금액 확인해 주세요	반품문의
반품 금액 확인해 주세요	반품문의
반품금액 어떻게 확인할수있을까요?	반품문의
반품 금액 어떻게 확인할수있을까요?	반품문의
반품금액 어떻게 확인할 수 있을까요?	반품문의
반품 금액 어떻게 확인할 수 있을까요?	반품문의
반품금액확인 어디에서 할수있나요?	반품문의
반품 금액확인 어디에서 할수있나요?	반품문의
반품금액 확인 어디에서 할수있나요?	반품문의
반품 금액 확인 어디에서 할수있나요?	반품문의
반품금액확인 어디에서 할 수 있나요?	반품문의
반품 금액확인 어디에서 할 수 있나요?	반품문의
반품금액 확인 어디에서 할 수 있나요?	반품문의
반품 금액 확인 어디에서 할 수 있나요?	반품문의
반품금액 확인하고싶어요 어디서 확인해야하나요?	반품문의
반품 금액 확인하고싶어요 어디서 확인해야하나요?	반품문의
반품금액 확인하고싶어요 어디서 확인해야하나요?	반품문의
환불금액 확인해주세요	반품문의
환불 금액 확인해주세요	반품문의
환불금액 확인 해주세요	반품문의
환불 금액 확인 해주세요	반품문의
환불금액 확인해 주세요	반품문의
환불 금액 확인해 주세요	반품문의
환불금액 알려주세요	반품문의
환불 금액 알려주세요	반품문의
환불금액 확인 해주세요	반품문의
환불 금액 확인 해주세요	반품문의
환불금액이 어떻게되나요?	반품문의
환불 금액이 어떻게되나요?	반품문의
환불금액이 어떻게 되나요?	반품문의
환불 금액이 어떻게 되나요?	반품문의
환불금액확인 어디서해요?	반품문의
환불 금액확인 어디서해요?	반품문의
환불금액 확인 어디서해요?	반품문의
환불 금액 확인 어디서해요?	반품문의
환불금액확인 어디서 해요?	반품문의
환불 금액확인 어디서 해요?	반품문의
환불금액 확인 어디서 해요?	반품문의
환불 금액 확인 어디서 해요?	반품문의
환불금액확인 어디서합니까?	반품문의
환불 금액확인 어디서합니까?	반품문의
환불금액 확인 어디서합니까?	반품문의
환불 금액 확인 어디서합니까?	반품문의
환불금액확인 어디서 합니까?	반품문의
환불 금액확인 어디서 합니까?	반품문의
환불금액 확인 어디서 합니까?	반품문의
환불 금액 확인 어디서 합니까?	반품문의
환불금액 알고싶습니다	반품문의
환불 금액 알고싶습니다	반품문의
환불금액 어디서 확인가능한가요?	반품문의
환불 금액 어디서 확인가능한가요?	반품문의
환불금액 어디서 확인 가능한가요?	반품문의
환불 금액 어디서 확인 가능한가요?	반품문의
환불금액 어떻게 확인할수있나요?	반품문의
환불 금액 어떻게 확인할수있나요?	반품문의
환불금액 어떻게 확인할 수 있나요?	반품문의
환불 금액 어떻게 확인할 수 있나요?	반품문의
환불금액 어떻게 확인해야할까요?	반품문의
환불 금액 어떻게 확인해야할까요?	반품문의
반품금액 얼마인지 확인 어디서합니까?	반품문의
반품 금액 얼마인지 확인 어디서합니까?	반품문의
반품금액 얼마인지 확인 어디서 합니까?	반품문의
반품 금액 얼마인지 확인 어디서 합니까?	반품문의
반품금액 얼마인지 확인 어떻게합니까?	반품문의
반품 금액 얼마인지 확인 어떻게합니까?	반품문의
반품금액 얼마인지 확인 어떻게 합니까?	반품문의
반품 금액 얼마인지 확인 어떻게 합니까?	반품문의
반품금액 어떻게 확인해야합니까?	반품문의
반품 금액 어떻게 확인해야합니까?	반품문의
반품금액 어떻게 확인할수있나요?	반품문의
반품 금액 어떻게 확인할수있나요?	반품문의
반품금액 어떻게 확인할 수 있나요?	반품문의
반품 금액 어떻게 확인할 수 있나요?	반품문의
반품 금액은 어디서 확인해?	반품문의
반품 금액은 어디서 확인 해?	반품문의
반품 금액 어디서 확인해?	반품문의
반품 금액 어디서 확인 해?	반품문의
반품 금액은 어디서 확인해요?	반품문의
반품 금액은 어디서 확인 해요?	반품문의
반품 금액 어디서 확인해요?	반품문의
반품 금액 어디서 확인 해요?	반품문의
반품 금액은 어디에서 확인해요?	반품문의
반품 금액은 어디에서 확인 해요?	반품문의
반품 금액 어디에서 확인해요?	반품문의
반품 금액 어디에서 확인 해요?	반품문의
반품 금액은 어디에서 확인해?	반품문의
반품 금액은 어디에서 확인 해요?	반품문의
반품 금액 어디에서 확인해?	반품문의
반품 금액 어디에서 확인 해요?	반품문의
반품 금액은 어디에서 확인합니까?	반품문의
반품 금액은 어디에서 확인 해요?	반품문의
반품 금액 어디에서 확인합니까?	반품문의
반품 금액 어디에서 확인 해요?	반품문의
환불금액 얼마인지 확인 어디서합니까?	반품문의
환불 금액 얼마인지 확인 어디서합니까?	반품문의
환불금액 얼마인지 확인 어디서 합니까?	반품문의
환불 금액 얼마인지 확인 어디서 합니까?	반품문의
환불금액 얼마인지 확인 어떻게합니까?	반품문의
환불 금액 얼마인지 확인 어떻게합니까?	반품문의
환불금액 얼마인지 확인 어떻게 합니까?	반품문의
환불 금액 얼마인지 확인 어떻게 합니까?	반품문의
환불금액 어떻게 확인해야합니까?	반품문의
환불 금액 어떻게 확인해야합니까?	반품문의
환불금액 어떻게 확인할수있나요?	반품문의
환불 금액 어떻게 확인할수있나요?	반품문의
환불금액 어떻게 확인할 수 있나요?	반품문의
환불 금액 어떻게 확인할 수 있나요?	반품문의
환불금액은 어디서확인해?	반품문의
환불 금액은 어디서확인해?	반품문의
환불금액은 어디서 확인해?	반품문의
환불 금액은 어디서 확인해?	반품문의
환불금액은 어디서확인해요?	반품문의
환불 금액은 어디서확인해요?	반품문의
환불금액은 어디서 확인해요?	반품문의
환불 금액은 어디서 확인해요?	반품문의
환불 금액은 어디에서 확인해요?	반품문의
환불 금액은 어디에서 확인 해요?	반품문의
환불 금액은 어디에서 확인합니까?	반품문의
환불 금액은 어디에서 확인 합니까?	반품문의
환불금액 어디서확인해?	반품문의
환불 금액 어디서확인해?	반품문의
환불금액 어디서 확인해?	반품문의
환불 금액 어디서 확인해?	반품문의
환불금액 어디서확인해요?	반품문의
환불 금액 어디서확인해요?	반품문의
환불금액 어디서 확인해요?	반품문의
환불 금액 어디서 확인해요?	반품문의
환불 금액 어디에서 확인해요?	반품문의
환불 금액 어디에서 확인 해요?	반품문의
환불 금액 어디에서 확인합니까?	반품문의
환불 금액 어디에서 확인 합니까?	반품문의
개봉한 제품도 반품이 가능한가요?	반품문의
개봉한 제품 반품 가능한가요?	반품문의
개봉한 제품 반품 하고싶어요	반품문의
개봉한 제품도 반품 가능한가요?	반품문의
개봉한 제품 반품 가능여부 궁금합니다	반품문의
개봉한 제품 반품 가능한가요?	반품문의
개봉한 제품 반품 가능한지 궁금합니다	반품문의
개봉한 제품 반품 가능한지 확인 부탁드립니다	반품문의
개봉한 제품 반품 가능여부 확인 부탁드립니다	반품문의
개봉한 제품 반품 가능한지 확인 부탁드려요	반품문의
개봉한 제품 반품하고싶은데 가능할까요?	반품문의
개봉한 제품 반품 가능한지 궁금합니다	반품문의
개봉한 제품 반품 요청하고싶은데 가능할까요?	반품문의
개봉한 제품 반품 하고싶습니다 어떻게 해야할까요?	반품문의
개봉한 제품도 반품이 가능한지 가능하다면 어떻게 해야하는지 궁금합니다	반품문의
개봉한 제품을 반품하려 하는데 어디에서 신청할 수 있는지 알려주세요	반품문의
반품 신청하려 하는데 개봉한 제품도 되나요?	반품문의
반품 신청하려합니다 개봉한 제품도 가능한가요?	반품문의
미개봉제품만 반품이 가능한가요?	반품문의
미개봉 제품만 반품 가능합니까?	반품문의
미개봉 제품만 반품할 수 있나요?	반품문의
미개봉 제품만 반품할 수 있나요?	반품문의
미개봉 상품만 반품이 가능한가요?	반품문의
미개봉 상품만 반품이 가능합니까?	반품문의
미개봉 상품만 반품이 가능할까요?	반품문의
미개봉 상품만 반품이 가능한지 궁금합니다	반품문의
미개봉 상품만 반품이 가능한지 알고싶습니다	반품문의
개봉한 제품 반품가능 어디서 확인해?	반품문의
개봉한 제품 반품가능은 어디서 확인해?	반품문의
개봉한 제품 반품가능 어디서 확인해요?	반품문의
개봉한 제품 반품가능은 어디서 확인해요?	반품문의
개봉한 제품 반품가능은 어디서 확인합니까?	반품문의
개봉한 제품 반품가능 어디서 확인합니까?	반품문의
개봉한 제품 반품품가능여부 어디서 확인해?	반품문의
개봉한 제품은 반품가능여부 어디서 확인해?	반품문의
개봉한 제품 반품가능여부 어디서 확인합니까?	반품문의
개봉한 제품은 반품가능여부 어디서 확인합니까?	반품문의
개봉한 제품 반품가능여부 어디서 확인해요?	반품문의
개봉한 제품은 반품가능여부 어디서 확인해요?	반품문의
개봉한 제품 반품가능여부 어디서 확인할 수 있죠?	반품문의
개봉한  제품은 반품가능여부 어디서 확인할 수 있죠?	반품문의
개봉한 제품 반품가능여부 어디서 확인할 수 있을까요?	반품문의
개봉한 제품은 반품가능여부 어디서 확인할 수 있을까요?	반품문의
개봉한제품도 반품이 가능한가요?	반품문의
개봉한제품 반품가능한가요?	반품문의
개봉한 제품 반품가능한가요?	반품문의
개봉한제품 반품 가능한가요?	반품문의
개봉한 제품 반품 가능한가요?	반품문의
개봉한제품 반품하고싶어요	반품문의
개봉한 제품 반품하고싶어요	반품문의
개봉한제품 반품 하고싶어요	반품문의
개봉한 제품 반품 하고싶어요	반품문의
개봉한제품도 반품가능한가요?	반품문의
개봉한 제품도 반품가능한가요?	반품문의
개봉한제품도 반품 가능한가요?	반품문의
개봉한 제품도 반품 가능한가요?	반품문의
개봉한제품 반품가능여부 궁금합니다	반품문의
개봉한 제품 반품가능여부 궁금합니다	반품문의
개봉한제품 반품 가능여부 궁금합니다	반품문의
개봉한 제품 반품 가능여부 궁금합니다	반품문의
개봉한제품 반품 가능여부 궁금합니다	반품문의
개봉한 제품 반품 가능여부 궁금합니다	반품문의
개봉한제품 반품가능한가요?	반품문의
개봉한 제품 반품가능한가요?	반품문의
개봉한제품 반품 가능한가요?	반품문의
개봉한 제품 반품 가능한가요?	반품문의
개봉한제품 반품가능한지 궁금합니다	반품문의
개봉한 제품 반품가능한지 궁금합니다	반품문의
개봉한제품 반품 가능한지 궁금합니다	반품문의
개봉한 제품 반품 가능한지 궁금합니다	반품문의
개봉한제품 반품가능한지 확인부탁드립니다	반품문의
개봉한제품 반품가능한지 확인부탁드립니다	반품문의
개봉한제품 반품 가능한지 확인부탁드립니다	반품문의
개봉한제품 반품 가능한지 확인부탁드립니다	반품문의
개봉한제품 반품 가능한지 확인 부탁드립니다	반품문의
개봉한제품 반품 가능한지 확인 부탁드립니다	반품문의
개봉한제품 반품가능여부 확인부탁드립니다	반품문의
개봉한 제품 반품가능여부 확인부탁드립니다	반품문의
개봉한제품 반품 가능여부 확인부탁드립니다	반품문의
개봉한 제품 반품 가능여부 확인부탁드립니다	반품문의
개봉한제품 반품 가능여부 확인 부탁드립니다	반품문의
개봉한 제품 반품 가능여부 확인 부탁드립니다	반품문의
개봉한제품 반품가능한지 확인부탁드려요	반품문의
개봉한 제품 반품가능한지 확인부탁드려요	반품문의
개봉한제품 반품 가능한지 확인부탁드려요	반품문의
개봉한 제품 반품 가능한지 확인부탁드려요	반품문의
개봉한제품 반품 가능한지 확인 부탁드려요	반품문의
개봉한 제품 반품 가능한지 확인 부탁드려요	반품문의
개봉한제품 반품하고싶은데 가능할까요?	반품문의
개봉한제품 반품하고싶은데 가능할까요?	반품문의
개봉한제품 반품 하고싶은데 가능할까요?	반품문의
개봉한제품 반품 하고싶은데 가능할까요?	반품문의
개봉한제품 반품가능한지 궁금합니다	반품문의
개봉한 제품 반품가능한지 궁금합니다	반품문의
개봉한제품 반품 가능한지 궁금합니다	반품문의
개봉한 제품 반품 가능한지 궁금합니다	반품문의
개봉한제품 반품요청하고싶은데 가능할까요?	반품문의
개봉한 제품 반품요청하고싶은데 가능할까요?	반품문의
개봉한제품 반품 요청하고싶은데 가능할까요?	반품문의
개봉한 제품 반품 요청하고싶은데 가능할까요?	반품문의
개봉한제품 반품하고싶습니다 어떻게 해야할까요?	반품문의
개봉한 제품 반품하고싶습니다 어떻게 해야할까요?	반품문의
개봉한제품 반품 하고싶습니다 어떻게 해야할까요?	반품문의
개봉한 제품 반품 하고싶습니다 어떻게 해야할까요?	반품문의
개봉한제품도 반품이 가능한지 가능하다면 어떻게 해야하는지궁금합니다	반품문의
개봉한 제품도 반품이 가능한지 가능하다면 어떻게 해야하는지궁금합니다	반품문의
개봉한제품도 반품이 가능한지 가능하다면 어떻게 해야하는지 궁금합니다	반품문의
개봉한 제품도 반품이 가능한지 가능하다면 어떻게 해야하는지 궁금합니다	반품문의
개봉한제품을 반품하려하는데 어디에서 신청할수있는지 알려주세요	반품문의
개봉한 제품을 반품하려하는데 어디에서 신청할수있는지 알려주세요	반품문의
개봉한제품을 반품 하려하는데 어디에서 신청할수있는지 알려주세요	반품문의
개봉한 제품을 반품 하려하는데 어디에서 신청할수있는지 알려주세요	반품문의
개봉한제품을 반품 하려하는데 어디에서 신청할 수 있는지 알려주세요	반품문의
개봉한 제품을 반품 하려하는데 어디에서 신청할 수 있는지 알려주세요	반품문의
반품신청하려 하는데 개봉한제품도 되나요?	반품문의
반품 신청하려 하는데 개봉한제품도 되나요?	반품문의
반품신청하려 하는데 개봉한 제품도 되나요?	반품문의
반품 신청하려 하는데 개봉한 제품도 되나요?	반품문의
반품신청하려합니다 개봉한 제품도 가능한가요?	반품문의
반품 신청하려합니다 개봉한 제품도 가능한가요?	반품문의
반품신청하려합니다 개봉한제품도 가능한가요?	반품문의
반품 신청하려합니다 개봉한제품도 가능한가요?	반품문의
미개봉제품만 반품이 가능한가요?	반품문의
미개봉 제품만 반품이 가능한가요?	반품문의
미개봉제품만 반품가능합니까?	반품문의
미개봉 제품만 반품가능합니까?	반품문의
미개봉제품만 반품 가능합니까?	반품문의
미개봉 제품만 반품 가능합니까?	반품문의
미개봉제품만 반품할수있나요?	반품문의
미개봉 제품만 반품할수있나요?	반품문의
미개봉제품만 반품할 수 있나요?	반품문의
미개봉 제품만 반품할 수 있나요?	반품문의
미개봉상품만 반품이 가능한가요?	반품문의
미개봉 상품만 반품이 가능한가요?	반품문의
미개봉상품만 반품이 가능합니까?	반품문의
미개봉 상품만 반품이 가능합니까?	반품문의
미개봉상품만 반품이 가능할까요?	반품문의
미개봉 상품만 반품이 가능할까요?	반품문의
미개봉상품만 반품이 가능한지궁금합니다	반품문의
미개봉 상품만 반품이 가능한지궁금합니다	반품문의
미개봉상품만 반품이 가능한지 궁금합니다	반품문의
미개봉 상품만 반품이 가능한지 궁금합니다	반품문의
미개봉상품만 반품이 가능한지알고싶습니다	반품문의
미개봉 상품만 반품이 가능한지알고싶습니다	반품문의
미개봉상품만 반품이 가능한지 알고싶습니다	반품문의
미개봉 상품만 반품이 가능한지 알고싶습니다	반품문의
미개봉상품만 반품이 가능한지 알고 싶습니다	반품문의
미개봉 상품만 반품이 가능한지 알고 싶습니다	반품문의
개봉한제품 반품가능 어디서 확인해?	반품문의
개봉한제품 반품 가능 어디서 확인해?	반품문의
개봉한 제품 반품가능 어디서 확인해?	반품문의
개봉한제품 반품가능은 어디서 확인해?	반품문의
개봉한제품 반품 가능은 어디서 확인해?	반품문의
개봉한 제품 반품가능은 어디서 확인해?	반품문의
개봉한제품 반품가능 어디서 확인해요?	반품문의
개봉한제품 반품 가능 어디서 확인해요?	반품문의
개봉한 제품 반품가능 어디서 확인해요?	반품문의
개봉한제품 반품가능은 어디서 확인해요?	반품문의
개봉한제품 반품 가능은 어디서 확인해요?	반품문의
개봉한 제품 반품가능은 어디서 확인해요?	반품문의
개봉한제품 반품가능은 어디서 확인합니까?	반품문의
개봉한제품 반품 가능은 어디서 확인합니까?	반품문의
개봉한 제품 반품가능은 어디서 확인합니까?	반품문의
개봉한제품 반품가능 어디서 확인합니까?	반품문의
개봉한제품 반품 가능 어디서 확인합니까?	반품문의
개봉한 제품 반품가능 어디서 확인합니까?	반품문의
개봉한제품 반품가능여부 어디서 확인해?	반품문의
개봉한 제품 반품가능여부 어디서 확인해?	반품문의
개봉한제품 반품 가능여부 어디서 확인해?	반품문의
개봉한 제품 반품 가능여부 어디서 확인해?	반품문의
개봉한제품 반품 가능여부 어디서 확인해?	반품문의
개봉한 제품 반품 가능여부 어디서 확인해?	반품문의
개봉한제품 반품 가능 여부 어디서 확인해?	반품문의
개봉한 제품 반품 가능 여부 어디서 확인해?	반품문의
개봉한제품 반품 가능 여부 어디서 확인 해?	반품문의
개봉한 제품 반품 가능 여부 어디서 확인 해?	반품문의
개봉한제품은 반품가능여부 어디서 확인해?	반품문의
개봉한 제품은 반품가능여부 어디서 확인해?	반품문의
개봉한제품은 반품 가능여부 어디서 확인해?	반품문의
개봉한 제품은 반품 가능여부 어디서 확인해?	반품문의
개봉한제품은 반품 가능여부 어디서 확인해?	반품문의
개봉한 제품은 반품 가능여부 어디서 확인해?	반품문의
개봉한제품은 반품 가능 여부 어디서 확인해?	반품문의
개봉한 제품은 반품 가능 여부 어디서 확인해?	반품문의
개봉한제품은 반품 가능 여부 어디서 확인 해?	반품문의
개봉한 제품은 반품 가능 여부 어디서 확인 해?	반품문의
개봉한제품 반품가능여부 어디서 확인합니까?	반품문의
개봉한 제품 반품가능여부 어디서 확인합니까?	반품문의
개봉한제품 반품 가능여부 어디서 확인합니까?	반품문의
개봉한 제품 반품 가능여부 어디서 확인합니까?	반품문의
개봉한제품 반품 가능여부 어디서 확인합니까?	반품문의
개봉한 제품 반품 가능여부 어디서 확인합니까?	반품문의
개봉한제품 반품 가능 여부 어디서 확인합니까?	반품문의
개봉한 제품 반품 가능 여부 어디서 확인합니까?	반품문의
개봉한제품 반품 가능 여부 어디서 확인 합니까?	반품문의
개봉한 제품 반품 가능 여부 어디서 확인 합니까?	반품문의
개봉한제품은 반품가능여부 어디서 확인합니까?	반품문의
개봉한 제품은 반품가능여부 어디서 확인합니까?	반품문의
개봉한제품은 반품 가능여부 어디서 확인합니까?	반품문의
개봉한 제품은 반품 가능여부 어디서 확인합니까?	반품문의
개봉한제품은 반품 가능여부 어디서 확인합니까?	반품문의
개봉한 제품은 반품 가능여부 어디서 확인합니까?	반품문의
개봉한제품은 반품 가능 여부 어디서 확인합니까?	반품문의
개봉한 제품은 반품 가능 여부 어디서 확인합니까?	반품문의
개봉한제품은 반품 가능 여부 어디서 확인 합니까?	반품문의
개봉한 제품은 반품 가능 여부 어디서 확인 합니까?	반품문의
개봉한제품 반품가능여부 어디서 확인해요?	반품문의
개봉한 제품 반품가능여부 어디서 확인해요?	반품문의
개봉한제품 반품 가능여부 어디서 확인해요?	반품문의
개봉한 제품 반품 가능여부 어디서 확인해요?	반품문의
개봉한제품 반품 가능여부 어디서 확인해요?	반품문의
개봉한 제품 반품 가능여부 어디서 확인해요?	반품문의
개봉한제품 반품 가능 여부 어디서 확인해요?	반품문의
개봉한 제품 반품 가능 여부 어디서 확인해요?	반품문의
개봉한제품 반품 가능 여부 어디서 확인 해요?	반품문의
개봉한 제품 반품 가능 여부 어디서 확인 해요?	반품문의
개봉한제품은 반품가능여부 어디서 확인해요?	반품문의
개봉한 제품은 반품가능여부 어디서 확인해요?	반품문의
개봉한제품은 반품 가능여부 어디서 확인해요?	반품문의
개봉한 제품은 반품 가능여부 어디서 확인해요?	반품문의
개봉한제품은 반품 가능여부 어디서 확인해요?	반품문의
개봉한 제품은 반품 가능여부 어디서 확인해요?	반품문의
개봉한제품은 반품 가능 여부 어디서 확인해요?	반품문의
개봉한 제품은 반품 가능 여부 어디서 확인해요?	반품문의
개봉한제품은 반품 가능 여부 어디서 확인 해요?	반품문의
개봉한 제품은 반품 가능 여부 어디서 확인 해요?	반품문의
개봉한제품 반품가능여부 어디서 확인할수있죠?	반품문의
개봉한 제품 반품가능여부 어디서 확인할수있죠?	반품문의
개봉한제품 반품 가능여부 어디서 확인할수있죠?	반품문의
개봉한 제품 반품 가능여부 어디서 확인할수있죠?	반품문의
개봉한제품 반품 가능여부 어디서 확인할수있죠?	반품문의
개봉한 제품 반품 가능여부 어디서 확인할수있죠?	반품문의
개봉한제품 반품 가능 여부 어디서 확인할수있죠?	반품문의
개봉한 제품 반품 가능 여부 어디서 확인할수있죠?	반품문의
개봉한제품 반품 가능 여부 어디서 확인 할수있죠?	반품문의
개봉한 제품 반품 가능 여부 어디서 확인 할수있죠?	반품문의
개봉한제품 반품 가능 여부 어디서 확인 할 수 있죠?	반품문의
개봉한 제품 반품 가능 여부 어디서 확인 할 수 있죠?	반품문의
개봉한 제품은 반품가능여부 어디서 확인할수있죠?	반품문의
개봉한  제품은 반품가능여부 어디서 확인할수있죠?	반품문의
개봉한 제품은 반품 가능여부 어디서 확인할수있죠?	반품문의
개봉한  제품은 반품 가능여부 어디서 확인할수있죠?	반품문의
개봉한 제품은 반품 가능여부 어디서 확인할수있죠?	반품문의
개봉한  제품은 반품 가능여부 어디서 확인할수있죠?	반품문의
개봉한 제품은 반품 가능 여부 어디서 확인할수있죠?	반품문의
개봉한  제품은 반품 가능 여부 어디서 확인할수있죠?	반품문의
개봉한 제품은 반품 가능 여부 어디서 확인 할수있죠?	반품문의
개봉한  제품은 반품 가능 여부 어디서 확인 할수있죠?	반품문의
개봉한 제품은 반품 가능 여부 어디서 확인 할 수 있죠?	반품문의
개봉한  제품은 반품 가능 여부 어디서 확인 할 수 있죠?	반품문의
개봉한제품 반품가능여부 어디서 확인할수있을까요?	반품문의
개봉한 제품 반품가능여부 어디서 확인할수있을까요?	반품문의
개봉한제품 반품 가능여부 어디서 확인할수있을까요?	반품문의
개봉한 제품 반품 가능여부 어디서 확인할수있을까요?	반품문의
개봉한제품 반품 가능여부 어디서 확인할수있을까요?	반품문의
개봉한 제품 반품 가능여부 어디서 확인할수있을까요?	반품문의
개봉한제품 반품 가능 여부 어디서 확인할수있을까요?	반품문의
개봉한 제품 반품 가능 여부 어디서 확인할수있을까요?	반품문의
개봉한제품 반품 가능 여부 어디서 확인 할수있을까요?	반품문의
개봉한 제품 반품 가능 여부 어디서 확인 할수있을까요?	반품문의
개봉한제품 반품 가능 여부 어디서 확인 할 수 있을까요?	반품문의
개봉한 제품 반품 가능 여부 어디서 확인 할 수 있을까요?	반품문의
개봉한제품은 반품가능여부 어디서 확인할수있을까요?	반품문의
개봉한 제품은 반품가능여부 어디서 확인할수있을까요?	반품문의
개봉한제품은 반품 가능여부 어디서 확인할수있을까요?	반품문의
개봉한 제품은 반품 가능여부 어디서 확인할수있을까요?	반품문의
개봉한제품은 반품 가능여부 어디서 확인할수있을까요?	반품문의
개봉한 제품은 반품 가능여부 어디서 확인할수있을까요?	반품문의
개봉한제품은 반품 가능 여부 어디서 확인할수있을까요?	반품문의
개봉한 제품은 반품 가능 여부 어디서 확인할수있을까요?	반품문의
개봉한제품은 반품 가능 여부 어디서 확인 할수있을까요?	반품문의
개봉한 제품은 반품 가능 여부 어디서 확인 할수있을까요?	반품문의
개봉한제품은 반품 가능 여부 어디서 확인 할 수 있을까요?	반품문의
개봉한 제품은 반품 가능 여부 어디서 확인 할 수 있을까요?	반품문의
지금 주문하면 언제 받을 수 있나요?	배송문의
지금 주문하면 언제 배송되나요?	배송문의
지금 구매하면 언제 배송되나요?	배송문의
오늘 구매하면 언제 배송되나요?	배송문의
지금 주문하면 언제쯤 도착하나요?	배송문의
주문하면 언제 받을 수 있나요?	배송문의
지금 주문하면 언제쯤 도착할까요?	배송문의
지금 주문하면 언제 받을수있습니까?	배송문의
지금 주문하면 언제받을수있습니까?	배송문의
지금 주문하면 언제 받을수 있습니까?	배송문의
지금 주문하면 언제 받을 수 있습니까?	배송문의
지금 주문하면 언제 받을 수 있나요?	배송문의
지금 주문하면 언제 받을수있나요?	배송문의
지금 주문하면 언제받을수있나요?	배송문의
지금주문하면 언제받을수있나요?	배송문의
지금 주문하면 언제 받을 수 있나요?	배송문의
지금 주문하면 언제 받을수있어요?	배송문의
지금 주문하면 언제 받을 수 있어요?	배송문의
주문하면 언제 받을 수 있을까요?	배송문의
주문하면 언제받을 수 있을까요?	배송문의
지금 주문하면 언제 받아볼수있나요?	배송문의
지금 주문하면 언제 받아볼 수 있나요?	배송문의
지금 주문하면 언제 받아볼 수 있을까요?	배송문의
지금주문하면 언제 받아볼수있을까요?	배송문의
지금 주문하면 제품 언제 받을수있어요?	배송문의
지금 주문하면 제품 언제받을수있어요?	배송문의
지금 주문하면 제품 언제 받을 수 있어요?	배송문의
지금 주문하면 제품 언제 받아볼 수 있을까요?	배송문의
주문하고 언제 받을 수 있는지 어떻게 확인해?	배송문의
주문하고 언제 받을 수 있는지 어떻게 확인해요?	배송문의
주문하고 언제 받을 수 있는지 어떻게 확인합니까?	배송문의
주문하고 언제 받을 수 있는지 어떻게 확인하나요?	배송문의
주문하고 언제 받을 수 있는지 어떻게 확인할수있나요?	배송문의
주문하고 언제 받을 수 있는지 어떻게 확인하는지 알려주세요	배송문의
주문하면 언제 받을 수 있는지 어떻게 확인해?	배송문의
주문하면 언제 받을 수 있는지 어떻게 확인해요?	배송문의
주문하면 언제 받을 수 있는지 어떻게 확인합니까?	배송문의
주문하면 언제 받을 수 있는지 어떻게 확인하나요?	배송문의
주문하면 언제 받을 수 있는지 어떻게 확인할수있나요?	배송문의
주문하면 언제 받을 수 있는지 어떻게 확인하는지 알려주세요	배송문의
주문한다면 언제 받을 수 있는지 어떻게 확인해?	배송문의
주문한다면 언제 받을 수 있는지 어떻게 확인해요?	배송문의
주문한다면 언제 받을 수 있는지 어떻게 확인합니까?	배송문의
주문한다면 언제 받을 수 있는지 어떻게 확인하나요?	배송문의
주문한다면 언제 받을 수 있는지 어떻게 확인할수있나요?	배송문의
주문한다면 언제 받을 수 있는지 어떻게 확인하는지 알려주세요	배송문의
지금 주문하면 언제배송되나요?	배송문의
지금 구매하면 언제배송되나요?	배송문의
오늘 구매하면 언제배송되나요?	배송문의
지금 주문하면 언제쯤도착하나요?	배송문의
주문하면 언제받을수있나요?	배송문의
주문하면 언제 받을수있나요?	배송문의
주문하면 언제 받을 수 있나요?	배송문의
지금 주문하면 언제쯤도착할까요?	배송문의
지금 주문하면 언제받아볼수있나요?	배송문의
지금 주문하면 언제 받아볼수있나요?	배송문의
지금 주문하면 언제 받아볼수있을까요?	배송문의
지금 주문하면 제품 언제 받아볼수있을까요?	배송문의
지금 주문하면 제품 언제받아볼수있을까요?	배송문의
주문하고 언제 받을수있는지 어떻게확인해?	배송문의
주문하고 언제 받을 수 있는지 어떻게확인해?	배송문의
주문하고 언제 받을 수 있는지 어떻게 확인해?	배송문의
주문하고 언제 받을수있는지 어떻게확인해요?	배송문의
주문하고 언제 받을 수 있는지 어떻게확인해요?	배송문의
주문하고 언제 받을 수 있는지 어떻게 확인해요?	배송문의
주문하고 언제 받을수있는지 어떻게확인합니까?	배송문의
주문하고 언제 받을 수 있는지 어떻게확인합니까?	배송문의
주문하고 언제 받을 수 있는지 어떻게 확인합니까?	배송문의
주문하고 언제 받을수있는지 어떻게확인하나요?	배송문의
주문하고 언제 받을 수 있는지 어떻게확인하나요?	배송문의
주문하고 언제 받을 수 있는지 어떻게 확인하나요?	배송문의
주문하고 언제 받을수있는지 어떻게확인할수있나요?	배송문의
주문하고 언제 받을 수 있는지 어떻게확인할수있나요?	배송문의
주문하고 언제 받을 수 있는지 어떻게 확인할수있나요?	배송문의
주문하고 언제 받을수있는지 어떻게확인하는지 알려주세요	배송문의
주문하고 언제 받을 수 있는지 어떻게확인하는지 알려주세요	배송문의
주문하고 언제 받을 수 있는지 어떻게 확인하는지 알려주세요	배송문의
주문하면 언제 받을수있는지 어떻게확인해?	배송문의
주문하면 언제 받을 수 있는지 어떻게확인해?	배송문의
주문하면 언제 받을 수 있는지 어떻게 확인해?	배송문의
주문하면 언제 받을수있는지 어떻게확인해요?	배송문의
주문하면 언제 받을 수 있는지 어떻게확인해요?	배송문의
주문하면 언제 받을 수 있는지 어떻게 확인해요?	배송문의
주문하면 언제 받을수있는지 어떻게확인합니까?	배송문의
주문하면 언제 받을 수 있는지 어떻게확인합니까?	배송문의
주문하면 언제 받을 수 있는지 어떻게 확인합니까?	배송문의
주문하면 언제 받을수있는지 어떻게확인하나요?	배송문의
주문하면 언제 받을 수 있는지 어떻게확인하나요?	배송문의
주문하면 언제 받을 수 있는지 어떻게 확인하나요?	배송문의
주문하면 언제 받을수있는지 어떻게확인할수있나요?	배송문의
주문하면 언제 받을 수 있는지 어떻게확인할수있나요?	배송문의
주문하면 언제 받을 수 있는지 어떻게 확인할수있나요?	배송문의
주문하면 언제 받을수있는지 어떻게 확인하는지알려주세요	배송문의
주문하면 언제 받을 수 있는지 어떻게 확인하는지알려주세요	배송문의
주문하면 언제 받을 수 있는지 어떻게 확인하는지 알려주세요	배송문의
주문한다면 언제 받을수있는지 어떻게확인해?	배송문의
주문한다면 언제 받을 수 있는지 어떻게확인해?	배송문의
주문한다면 언제 받을수있는지 어떻게확인해요?	배송문의
주문한다면 언제 받을 수 있는지 어떻게확인해요?	배송문의
주문한다면 언제 받을수있는지 어떻게확인합니까?	배송문의
주문한다면 언제 받을 수 있는지 어떻게확인합니까?	배송문의
주문한다면 언제 받을수있는지 어떻게확인하나요?	배송문의
주문한다면 언제 받을 수 있는지 어떻게확인하나요?	배송문의
주문한다면 언제 받을수있는지 어떻게 확인할수있나요?	배송문의
주문한다면 언제 받을수있는지 어떻게확인할수있나요?	배송문의
주문한다면 언제 받을수있는지 어떻게 확인하는지 알려주세요	배송문의
주문한다면 언제 받을수있는지 어떻게 확인하는지알려주세요	배송문의
제품을 주문했는데 언제 받아볼 수 있나요?	배송문의
배송 완료 예정이 언제인가요?	배송문의
배송은 언제 되나요?	배송문의
배송은 언제 될까요?	배송문의
배송은 언제까지 되나요?	배송문의
언제 배송돼요?	배송문의
배송 언제 돼요?	배송문의
배송은 언제 되는지 알고 싶습니다	배송문의
언제 배송되는지 알 수 있을까요?	배송문의
언제 배송되는지 알수있을까요?	배송문의
언제 배송되는지 알고싶습니다	배송문의
배송 언제되는지 알 수 있을까요?	배송문의
배송 언제되는지 알수있을까요?	배송문의
배송언제되는지 알수있을까요?	배송문의
배송언제되는지 알 수 있을까요?	배송문의
배송 언제될까요?	배송문의
배송 언제돼요?	배송문의
배송 언제되요?	배송문의
배송 언제해요?	배송문의
배송 언제 해요?	배송문의
배송 언제 돼요?	배송문의
배송 언제 되요?	배송문의
상품 주문했는데 언제 받아볼 수 있나요?	배송문의
상품 주문했는데 언제받아볼수있나요?	배송문의
상품주문했는데 언제 받아볼수있어요?	배송문의
상품 주문했는데 언제 받아볼수있어요?	배송문의
상품 주문했는데 언제 받아볼 수 있어요?	배송문의
상품 주문했는데 언제 받아볼 수 있을까요?	배송문의
상품주문했는데 언제 받아볼수있을까요?	배송문의
상품주문했는데 언제 받아볼 수 있나요?	배송문의
제품 수령일 확인	배송문의
제품 수령일 확인해줘	배송문의
제품 수령일 확인해주세요	배송문의
제품 수령일 확인부탁드려요	배송문의
제품 수령일 확인부탁드립니다	배송문의
제품 수령일 알려주세요	배송문의
제품 수령일 알려주실수있나요?	배송문의
제품 수령일 알려줘	배송문의
상품수령일 확인	배송문의
상품수령일 확인해줘	배송문의
상품수령일 확인해주세요	배송문의
상품수령일 확인부탁드려요	배송문의
상품수령일 확인부탁드립니다	배송문의
상품수령일 알려주세요	배송문의
상품수령일 알려주실수있나요?	배송문의
상품수령일 알려줘	배송문의
배송완료예정이 언제인가요?	배송문의
배송 완료예정이 언제인가요?	배송문의
배송완료 예정이 언제인가요?	배송문의
배송 완료 예정이 언제인가요?	배송문의
배송은 언제되나요?	배송문의
배송은 언제될까요?	배송문의
배송은 언제까지되나요?	배송문의
배송 언제돼요?	배송문의
배송은 언제되는지 알고싶습니다	배송문의
배송은 언제 되는지 알고싶습니다	배송문의
배송은 언제되는지 알고 싶습니다	배송문의
배송은 언제 되는지 알고 싶습니다	배송문의
배송 언제 될까요?	배송문의
상품주문했는데 언제 받아볼수있나요?	배송문의
상품 주문했는데 언제 받아볼수있나요?	배송문의
상품주문 했는데 언제 받아볼수있나요?	배송문의
상품 주문 했는데 언제 받아볼수있나요?	배송문의
상품주문했는데 언제 받아볼 수 있나요?	배송문의
상품 주문했는데 언제 받아볼 수 있나요?	배송문의
상품주문 했는데 언제 받아볼 수 있나요?	배송문의
상품 주문 했는데 언제 받아볼 수 있나요?	배송문의
상품주문했는데 언제받아볼수있어요?	배송문의
상품 주문했는데 언제받아볼수있어요?	배송문의
상품주문했는데 언제 받아볼수있어요?	배송문의
상품 주문했는데 언제 받아볼수있어요?	배송문의
상품주문했는데 언제 받아볼 수 있어요?	배송문의
상품 주문했는데 언제 받아볼 수 있어요?	배송문의
상품주문했는데 언제받아볼수있을까요?	배송문의
상품 주문했는데 언제받아볼수있을까요?	배송문의
상품주문했는데 언제 받아볼수있을까요?	배송문의
상품 주문했는데 언제 받아볼수있을까요?	배송문의
상품주문했는데 언제 받아볼 수 있을까요?	배송문의
상품 주문했는데 언제 받아볼 수 있을까요?	배송문의
제품수령일확인	배송문의
제품 수령일확인	배송문의
제품수령일 확인	배송문의
제품수령일확인해줘	배송문의
제품 수령일확인해줘	배송문의
제품수령일 확인해줘	배송문의
제품 수령일 확인해줘	배송문의
제품수령일확인해주세요	배송문의
제품 수령일확인해주세요	배송문의
제품수령일 확인해주세요	배송문의
제품 수령일 확인해주세요	배송문의
제품수령일확인해주세요	배송문의
제품 수령일확인해 주세요	배송문의
제품수령일 확인해 주세요	배송문의
제품 수령일 확인해 주세요	배송문의
제품수령일확인부탁드려요	배송문의
제품 수령일확인부탁드려요	배송문의
제품수령일 확인부탁드려요	배송문의
제품 수령일 확인부탁드려요	배송문의
제품수령일 확인 부탁드려요	배송문의
제품 수령일 확인 부탁드려요	배송문의
제품수령일확인부탁드립니다	배송문의
제품 수령일확인부탁드립니다	배송문의
제품수령일 확인부탁드립니다	배송문의
제품 수령일 확인부탁드립니다	배송문의
제품수령일확인 부탁드립니다	배송문의
제품 수령일확인 부탁드립니다	배송문의
제품수령일 확인 부탁드립니다	배송문의
제품 수령일 확인 부탁드립니다	배송문의
제품수령일알려주세요	배송문의
제품 수령일알려주세요	배송문의
제품수령일 알려주세요	배송문의
제품수령일 알려주실수있나요?	배송문의
제품 수령일 알려주실수있나요?	배송문의
제품수령일 알려주실 수 있나요?	배송문의
제품 수령일 알려주실 수 있나요?	배송문의
제품수령일알려줘	배송문의
제품 수령일알려줘	배송문의
제품수령일 알려줘	배송문의
상품수령일확인	배송문의
상품 수령일확인	배송문의
상품 수령일 확인	배송문의
상품수령일 확인해줘	배송문의
상품 수령일 확인해줘	배송문의
상품 수령일 확인해주세요	배송문의
상품 수령일 확인 해주세요	배송문의
상품 수령일 확인부탁드려요	배송문의
상품 수령일 확인 부탁드려요	배송문의
상품수령일 확인 부탁드려요	배송문의
상품수령일 확인 부탁드립니다	배송문의
상품 수령일 확인부탁드립니다	배송문의
상품 수령일 확인 부탁드립니다	배송문의
상품 수령일 알려주세요	배송문의
상품 수령일 알려주실수있나요?	배송문의
상품수령일 알려주실 수 있나요?	배송문의
상품 수령일 알려주실 수 있나요?	배송문의
상품수령일알려줘	배송문의
주문한 제품의 배송조회가 가능한가요?	배송문의
배송조회 해주세요	배송문의
배송조회 가능할까요?	배송문의
배송조회 부탁드립니다	배송문의
주문한 제품 배송조회 해주세요	배송문의
주문한 제품 배송조회해주세요	배송문의
배송조회 부탁드려요	배송문의
어떻게 하면 배송조회를 할 수 있나요?	배송문의
배송조회를 하고싶습니다 어떻게 해야할까요?	배송문의
주문한 제품의 배송조회를 하려면 어떻게 해야합니까?	배송문의
주문한 제품의 배송조회를 하고 싶습니다 어떻게 해야 되나요?	배송문의
주문한 제품의 배송조회가 어디서 가능한가요?	배송문의
주문한 제품의 배송조회를 하고 싶습니다 어디서 가능한가요?	배송문의
배송조회를 하고 싶습니다 어디서 확인할 수 있나요?	배송문의
배송조회를 어디서 할 수 있나요?	배송문의
배송조회 어디서 확인 가능한가요?	배송문의
제품 배송조회 어디서 합니까?	배송문의
제품 배송조회 어디서 할 수 있나요?	배송문의
제품 배송조회 하고싶어요	배송문의
제품 배송조회 하는 방법 궁금합니다	배송문의
제품 배송조회 할 수 있는 방법이 있나요?	배송문의
제품 배송조회가 가능합니까?	배송문의
배송조회 후 연락주세요	배송문의
주문한 제품 배송조회 후 알려주세요	배송문의
제품 주문했는데요 배송조회 부탁드립니다	배송문의
주문한 제품이 있습니다 배송조회 부탁드립니다	배송문의
주문한 제품이 있습니다 배송조회 가능한가요?	배송문의
제품을 주문했습니다 배송조회 가능할까요?	배송문의
제품을 주문했습니다 배송조회 부탁드립니다	배송문의
제품을 주문했습니다 배송조회 어떻게 하나요?	배송문의
제품을 주문했습니다 배송조회하려면 어떻게 해야하나요?	배송문의
주문한 제품의 배송조회는 어떻게 해?	배송문의
주문한 제품의 배송조회는 어떻게 해요?	배송문의
주문한 제품의 배송조회는 어떻게 합니까?	배송문의
주문한 제품의 배송조회는 어떻게 하나요?	배송문의
주문한 제품의 배송조회는 어떻게 해야하나요?	배송문의
주문한 제품의 배송조회는 어떻게 하는지알려주세요	배송문의
제품주문했는데 배송조회는 어떻게 해?	배송문의
제품주문했는데 배송조회는 어떻게 해요?	배송문의
제품주문했는데 배송조회는 어떻게 합니까?	배송문의
제품주문했는데 배송조회는 어떻게 하나요?	배송문의
제품주문했는데 배송조회는 어떻게 해야하나요?	배송문의
제품주문했는데 배송조회는 어떻게 하는지알려주세요	배송문의
상품주문했는데 배송조회는 어떻게 해?	배송문의
상품주문했는데 배송조회는 어떻게 해요?	배송문의
상품주문했는데 배송조회는 어떻게 합니까?	배송문의
상품주문했는데 배송조회는 어떻게 하나요?	배송문의
상품주문했는데 배송조회는 어떻게 해야하나요?	배송문의
상품주문했는데 배송조회는 어떻게 하는지알려주세요	배송문의
배송조회해주세요	배송문의
배송조회 부탁 드립니다	배송문의
주문한제품 배송조회해주세요	배송문의
주문한 제품 배송조회해주세요	배송문의
주문한제품 배송조회 해주세요	배송문의
주문한 제품 배송조회 해주세요	배송문의
배송조회부탁드려요	배송문의
어떻게하면 배송조회를 할수있나요?	배송문의
어떻게 하면 배송조회를 할수있나요?	배송문의
어떻게하면 배송 조회를 할수있나요?	배송문의
어떻게 하면 배송 조회를 할수있나요?	배송문의
어떻게하면 배송 조회를 할 수 있나요?	배송문의
어떻게 하면 배송 조회를 할 수 있나요?	배송문의
배송조회를 하고싶습니다 어떻게해야할까요?	배송문의
배송 조회를 하고싶습니다 어떻게해야할까요?	배송문의
배송조회를 하고싶습니다 어떻게 해야할까요?	배송문의
배송 조회를 하고싶습니다 어떻게 해야할까요?	배송문의
주문한제품의 배송조회를 하려면 어떻게해야합니까?	배송문의
주문한 제품의 배송조회를 하려면 어떻게해야합니까?	배송문의
주문한제품의 배송 조회를 하려면 어떻게해야합니까?	배송문의
주문한 제품의 배송 조회를 하려면 어떻게해야합니까?	배송문의
주문한제품의 배송 조회를 하려면 어떻게 해야합니까?	배송문의
주문한 제품의 배송 조회를 하려면 어떻게 해야합니까?	배송문의
주문한제품의 배송조회를 하고싶습니다 어떻게해야되나요?	배송문의
주문한 제품의 배송조회를 하고싶습니다 어떻게해야되나요?	배송문의
주문한제품의 배송 조회를 하고싶습니다 어떻게해야되나요?	배송문의
주문한 제품의 배송 조회를 하고싶습니다 어떻게해야되나요?	배송문의
주문한제품의 배송 조회를 하고싶습니다 어떻게 해야되나요?	배송문의
주문한 제품의 배송 조회를 하고싶습니다 어떻게 해야되나요?	배송문의
주문한제품의 배송 조회를 하고싶습니다 어떻게 해야 되나요?	배송문의
주문한 제품의 배송 조회를 하고싶습니다 어떻게 해야 되나요?	배송문의
주문한제품의 배송조회가 어디서가능한가요?	배송문의
주문한 제품의 배송조회가 어디서가능한가요?	배송문의
주문한제품의 배송 조회가 어디서가능한가요?	배송문의
주문한 제품의 배송 조회가 어디서가능한가요?	배송문의
주문한제품의 배송 조회가 어디서 가능한가요?	배송문의
주문한 제품의 배송 조회가 어디서 가능한가요?	배송문의
주문한제품의 배송조회를 하고싶습니다 어디서가능한가요?	배송문의
주문한 제품의 배송조회를 하고싶습니다 어디서가능한가요?	배송문의
주문한제품의 배송 조회를 하고싶습니다 어디서가능한가요?	배송문의
주문한 제품의 배송 조회를 하고싶습니다 어디서가능한가요?	배송문의
주문한제품의 배송 조회를 하고 싶습니다 어디서가능한가요?	배송문의
주문한 제품의 배송 조회를 하고 싶습니다 어디서가능한가요?	배송문의
주문한제품의 배송 조회를 하고 싶습니다 어디서 가능한가요?	배송문의
주문한 제품의 배송 조회를 하고 싶습니다 어디서 가능한가요?	배송문의
배송조회를 하고싶습니다 어디서 확인할수있나요?	배송문의
배송 조회를 하고싶습니다 어디서 확인할수있나요?	배송문의
배송조회를 하고 싶습니다 어디서 확인할수있나요?	배송문의
배송 조회를 하고 싶습니다 어디서 확인할수있나요?	배송문의
배송조회를 하고 싶습니다 어디서 확인할 수 있나요?	배송문의
배송 조회를 하고 싶습니다 어디서 확인할 수 있나요?	배송문의
배송조회를 어디서 할수있나요?	배송문의
배송 조회를 어디서 할수있나요?	배송문의
배송조회를 어디서 할 수 있나요?	배송문의
배송 조회를 어디서 할 수 있나요?	배송문의
배송조회 어디서 확인가능한가요?	배송문의
배송 조회 어디서 확인가능한가요?	배송문의
배송조회 어디서 확인 가능한가요?	배송문의
배송 조회 어디서 확인 가능한가요?	배송문의
제품배송조회 어디서합니까?	배송문의
제품 배송조회 어디서합니까?	배송문의
제품배송 조회 어디서합니까?	배송문의
제품 배송 조회 어디서합니까?	배송문의
제품배송조회 어디서 합니까?	배송문의
제품 배송조회 어디서 합니까?	배송문의
제품배송 조회 어디서 합니까?	배송문의
제품 배송 조회 어디서 합니까?	배송문의
제품배송조회 어디서 할수있나요?	배송문의
제품 배송조회 어디서 할수있나요?	배송문의
제품배송 조회 어디서 할수있나요?	배송문의
제품 배송 조회 어디서 할수있나요?	배송문의
제품배송조회 어디서 할 수 있나요?	배송문의
제품 배송조회 어디서 할 수 있나요?	배송문의
제품배송 조회 어디서 할 수 있나요?	배송문의
제품 배송 조회 어디서 할 수 있나요?	배송문의
제품배송조회 하고싶어요	배송문의
제품 배송조회 하고싶어요	배송문의
제품배송 조회 하고싶어요	배송문의
제품 배송 조회 하고싶어요	배송문의
제품배송조회 하고 싶어요	배송문의
제품 배송조회 하고 싶어요	배송문의
제품배송 조회 하고 싶어요	배송문의
제품 배송 조회 하고 싶어요	배송문의
제품배송조회 하는방법 궁금합니다	배송문의
제품 배송조회 하는방법 궁금합니다	배송문의
제품배송 조회 하는방법 궁금합니다	배송문의
제품 배송 조회 하는방법 궁금합니다	배송문의
제품배송조회 하는 방법 궁금합니다	배송문의
제품 배송조회 하는 방법 궁금합니다	배송문의
제품배송 조회 하는 방법 궁금합니다	배송문의
제품 배송조 회 하는 방법 궁금합니다	배송문의
제품배송조회 할수있는 방법이 있나요?	배송문의
제품 배송조회 할수있는 방법이 있나요?	배송문의
제품배송 조회 할수있는 방법이 있나요?	배송문의
제품 배송 조회 할수있는 방법이 있나요?	배송문의
제품배송조회 할 수 있는 방법이 있나요?	배송문의
제품 배송조회 할 수 있는 방법이 있나요?	배송문의
제품배송 조회 할 수 있는 방법이 있나요?	배송문의
제품 배송조회 할 수 있는 방법이 있나요?	배송문의
제품배송조회가 가능합니까?	배송문의
제품 배송조회가 가능합니까?	배송문의
제품배송 조회가 가능합니까?	배송문의
제품 배송 조회가 가능합니까?	배송문의
배송조회후 연락주세요	배송문의
주문한제품 배송조회후 알려주세요	배송문의
주문한 제품 배송조회후 알려주세요	배송문의
주문한제품 배송조회 후 알려주세요	배송문의
주문한 제품 배송조회 후 알려주세요	배송문의
제품주문했는데요 배송조회부탁드립니다	배송문의
제품 주문했는데요 배송조회부탁드립니다	배송문의
제품주문했는데요 배송 조회부탁드립니다	배송문의
제품 주문했는데요 배송 조회부탁드립니다	배송문의
제품주문했는데요 배송 조회 부탁드립니다	배송문의
제품 주문했는데요 배송 조회 부탁드립니다	배송문의
주문한제품이 있습니다 배송조회부탁드립니다	배송문의
주문한 제품이 있습니다 배송조회부탁드립니다	배송문의
주문한제품이 있습니다 배송 조회부탁드립니다	배송문의
주문한 제품이 있습니다 배송 조회부탁드립니다	배송문의
주문한제품이 있습니다 배송 조회 부탁드립니다	배송문의
주문한 제품이 있습니다 배송 조회 부탁드립니다	배송문의
주문한제품이 있습니다 배송조회가능한가요?	배송문의
주문한 제품이 있습니다 배송조회가능한가요?	배송문의
주문한제품이 있습니다 배송 조회가능한가요?	배송문의
주문한 제품이 있습니다 배송 조회가능한가요?	배송문의
주문한제품이 있습니다 배송 조회 가능한가요?	배송문의
주문한 제품이 있습니다 배송 조회 가능한가요?	배송문의
제품을 주문했습니다 배송조회가능할까요?	배송문의
제품을 주문했습니다 배송 조회가능할까요?	배송문의
제품을 주문했습니다 배송조회 가능할까요?	배송문의
제품을 주문했습니다 배송조회부탁드립니다	배송문의
제품을 주문했습니다 배송 조회부탁드립니다	배송문의
제품을 주문했습니다 배송조회 부탁드립니다	배송문의
제품을 주문했습니다 배송 조회 부탁드립니다	배송문의
제품을 주문했습니다 배송조회 어떻게하나요?	배송문의
제품을 주문했습니다 배송 조회 어떻게하나요?	배송문의
제품을 주문했습니다 배송조회 어떻게 하나요?	배송문의
제품을 주문했습니다 배송 조회 어떻게 하나요?	배송문의
제품을 주문했습니다 배송 조회하려면 어떻게 해야하나요?	배송문의
주문한제품의 배송조회는 어떻게해?	배송문의
주문한 제품의 배송조회는 어떻게해?	배송문의
주문한제품의 배송 조회는 어떻게해?	배송문의
주문한제품의 배송 조회는 어떻게 해?	배송문의
주문한 제품의 배송 조회는 어떻게 해?	배송문의
주문한제품의 배송조회는 어떻게해요?	배송문의
주문한 제품의 배송조회는 어떻게해요?	배송문의
주문한제품의 배송 조회는 어떻게해요?	배송문의
주문한제품의 배송조회는 어떻게 해요?	배송문의
주문한 제품의 배송 조회는 어떻게해요?	배송문의
주문한 제품의 배송 조회는 어떻게 해요?	배송문의
주문한제품의 배송조회는 어떻게합니까?	배송문의
주문한 제품의 배송조회는 어떻게합니까?	배송문의
주문한제품의 배송 조회는 어떻게합니까?	배송문의
주문한제품의 배송조회는 어떻게 합니까?	배송문의
주문한 제품의 배송조회는 어떻게 합니까?	배송문의
주문한 제품의 배송 조회는 어떻게 합니까?	배송문의
주문한제품의 배송조회는 어떻게하나요?	배송문의
주문한 제품의 배송조회는 어떻게하나요?	배송문의
주문한제품의 배송 조회는 어떻게하나요?	배송문의
주문한 제품의 배송 조회는 어떻게하나요?	배송문의
주문한제품의 배송 조회는 어떻게 하나요?	배송문의
주문한 제품의 배송 조회는 어떻게 하나요?	배송문의
주문한제품의 배송조회는 어떻게해야하나요?	배송문의
주문한 제품의 배송조회는 어떻게해야하나요?	배송문의
주문한제품의 배송 조회는 어떻게해야하나요?	배송문의
주문한 제품의 배송 조회는 어떻게해야하나요?	배송문의
주문한제품의 배송 조회는 어떻게 해야하나요?	배송문의
주문한 제품의 배송 조회는 어떻게 해야하나요?	배송문의
주문한제품의 배송조회는 어떻게하는지알려주세요	배송문의
주문한 제품의 배송조회는 어떻게하는지알려주세요	배송문의
주문한제품의 배송 조회는 어떻게하는지알려주세요	배송문의
주문한 제품의 배송 조회는 어떻게하는지알려주세요	배송문의
주문한제품의 배송 조회는 어떻게 하는지알려주세요	배송문의
주문한 제품의 배송 조회는 어떻게 하는지알려주세요	배송문의
주문한제품의 배송 조회는 어떻게 하는지 알려주세요	배송문의
주문한 제품의 배송 조회는 어떻게 하는지 알려주세요	배송문의
제품주문했는데 배송조회는 어떻게해?	배송문의
제품 주문했는데 배송조회는 어떻게해?	배송문의
제품주문했는데 배송 조회는 어떻게해?	배송문의
제품 주문했는데 배송 조회는 어떻게해?	배송문의
제품주문했는데 배송 조회는 어떻게 해?	배송문의
제품 주문했는데 배송 조회는 어떻게 해?	배송문의
제품주문했는데 배송조회는 어떻게해요?	배송문의
제품 주문했는데 배송조회는 어떻게해요?	배송문의
제품주문했는데 배송 조회는 어떻게해요?	배송문의
제품 주문했는데 배송 조회는 어떻게해요?	배송문의
제품주문했는데 배송 조회는 어떻게 해요?	배송문의
제품 주문했는데 배송 조회는 어떻게 해요?	배송문의
제품주문했는데 배송조회는 어떻게합니까?	배송문의
제품 주문했는데 배송조회는 어떻게합니까?	배송문의
제품주문했는데 배송 조회는 어떻게합니까?	배송문의
제품 주문했는데 배송 조회는 어떻게합니까?	배송문의
제품주문했는데 배송 조회는 어떻게 합니까?	배송문의
제품 주문했는데 배송 조회는 어떻게 합니까?	배송문의
제품주문했는데 배송조회는 어떻게하나요?	배송문의
제품 주문했는데 배송조회는 어떻게하나요?	배송문의
제품주문했는데 배송 조회는 어떻게하나요?	배송문의
제품 주문했는데 배송 조회는 어떻게하나요?	배송문의
제품주문했는데 배송 조회는 어떻게 하나요?	배송문의
제품 주문했는데 배송 조회는 어떻게 하나요?	배송문의
제품주문했는데 배송조회는 어떻게해야하나요?	배송문의
제품 주문했는데 배송조회는 어떻게해야하나요?	배송문의
제품주문했는데 배송 조회는 어떻게해야하나요?	배송문의
제품 주문했는데 배송 조회는 어떻게해야하나요?	배송문의
제품주문했는데 배송 조회는 어떻게 해야하나요?	배송문의
제품 주문했는데 배송 조회는 어떻게 해야하나요?	배송문의
제품주문했는데 배송 조회는 어떻게 해야 하나요?	배송문의
제품 주문했는데 배송 조회는 어떻게 해야 하나요?	배송문의
제품주문했는데 배송조회는 어떻게하는지알려주세요	배송문의
제품 주문했는데 배송조회는 어떻게하는지알려주세요	배송문의
제품주문했는데 배송 조회는 어떻게하는지알려주세요	배송문의
제품 주문했는데 배송 조회는 어떻게하는지알려주세요	배송문의
제품주문했는데 배송 조회는 어떻게 하는지알려주세요	배송문의
제품 주문했는데 배송 조회는 어떻게 하는지알려주세요	배송문의
상품주문했는데 배송조회는 어떻게해?	배송문의
상품 주문했는데 배송조회는 어떻게해?	배송문의
상품주문했는데 배송 조회는 어떻게해?	배송문의
상품 주문했는데 배송 조회는 어떻게해?	배송문의
상품주문했는데 배송 조회는 어떻게 해?	배송문의
상품 주문했는데 배송 조회는 어떻게 해?	배송문의
상품주문했는데 배송조회는 어떻게해요?	배송문의
상품 주문했는데 배송조회는 어떻게해요?	배송문의
상품주문했는데 배송 조회는 어떻게해요?	배송문의
상품 주문했는데 배송 조회는 어떻게해요?	배송문의
상품주문했는데 배송 조회는 어떻게 해요?	배송문의
상품 주문했는데 배송 조회는 어떻게 해요?	배송문의
상품주문했는데 배송조회는 어떻게합니까?	배송문의
상품 주문했는데 배송조회는 어떻게합니까?	배송문의
상품주문했는데 배송 조회는 어떻게합니까?	배송문의
상품 주문했는데 배송 조회는 어떻게합니까?	배송문의
상품주문했는데 배송 조회는 어떻게 합니까?	배송문의
상품 주문했는데 배송 조회는 어떻게 합니까?	배송문의
상품주문했는데 배송조회는 어떻게하나요?	배송문의
상품 주문했는데 배송조회는 어떻게하나요?	배송문의
상품주문했는데 배송 조회는 어떻게하나요?	배송문의
상품 주문했는데 배송 조회는 어떻게하나요?	배송문의
상품주문했는데 배송 조회는 어떻게 하나요?	배송문의
상품 주문했는데 배송 조회는 어떻게 하나요?	배송문의
상품주문했는데 배송조회는 어떻게해야하나요?	배송문의
상품 주문했는데 배송조회는 어떻게해야하나요?	배송문의
상품주문했는데 배송 조회는 어떻게해야하나요?	배송문의
상품 주문했는데 배송 조회는 어떻게해야하나요?	배송문의
상품주문했는데 배송 조회는 어떻게 해야하나요?	배송문의
상품 주문했는데 배송 조회는 어떻게 해야하나요?	배송문의
상품주문했는데 배송조회는 어떻게하는지알려주세요	배송문의
상품 주문했는데 배송조회는 어떻게하는지알려주세요	배송문의
상품주문했는데 배송 조회는 어떻게하는지알려주세요	배송문의
상품 주문했는데 배송 조회는 어떻게하는지알려주세요	배송문의
상품주문했는데 배송 조회는 어떻게 하는지알려주세요	배송문의
상품 주문했는데 배송 조회는 어떻게 하는지알려주세요	배송문의
당일 배송 제품은 언제 도착하나요?	배송문의
배송 도착시간 언제인가요?	배송문의
배송 도착 시간 궁금해요	배송문의
배송 언제 도착하나요?	배송문의
배송 언제 도착해요?	배송문의
배송 언제 도착	배송문의
당일배송 언제 도착해요?	배송문의
당일배송 언제 도착하는지 궁금해요	배송문의
당일배송 언제 도착하는지 알려주세요	배송문의
당일배송 언제 도착해요?	배송문의
당일배송 제품 언제 도착해요?	배송문의
당일배송제품 언제 도착합니까?	배송문의
당일 배송 제품이 언제 도착하는지 어떻게 확인할 수 있나요?	배송문의
당일 배송 제품이 언제 도착하는지 확인해주세요	배송문의
당일 배송 제품을 주문했습니다 몇 시에 받아 볼 수 있을까요?	배송문의
당일배송 도착시간은 어떻게 확인 할 수 있나요?	배송문의
당일 배송 제품의 도착시간 알 수 있나요?	배송문의
당일 배송 제품의 도착시간 알고싶습니다	배송문의
당일 배송 제품 몇시에 도착합니까?	배송문의
당일 배송 제품 보통 언제 도착하나요?	배송문의
당일 배송은 언제 도착하나요?	배송문의
당일 배송은 언제 도착합니까?	배송문의
당일 배송은 보통 언제 도착해요?	배송문의
당일 배송 제품의 도착시간이 궁금합니다	배송문의
당일 배송 제품 도착시간 알려주세요	배송문의
당일배송제품 도착시간 알려주세요	배송문의
당일 배송제품 도착시간 알려주세요	배송문의
당일배송 제품 도착시간 알려주세요	배송문의
당일배송제품 도착시간알려주세요	배송문의
당일배송상품 도착시간알려주세요	배송문의
당일 배송상품 도착시간알려주세요	배송문의
당일배송 상품 도착시간알려주세요	배송문의
당일배송상품 도착시간 알려주세요	배송문의
당일 배송상품 도착시간 알려주세요	배송문의
당일배송 상품 도착시간 알려주세요	배송문의
당일배송 도착시간 어떻게 확인해?	배송문의
당일배송 도착시간 어떻게 확인해요?	배송문의
당일배송 도착시간 어떻게 확인합니까?	배송문의
당일배송 도착시간 어떻게 확인하나요?	배송문의
당일배송 도착시간 어떻게 확인됩니까?	배송문의
당일배송 도착시간 어떻게 확인할수있나요?	배송문의
당일배송 도착시간 어떻게 확인해야하나요?	배송문의
당일배송 도착시간 어떻게 확인이 가능할까요?	배송문의
당일배송 도착시간 어떻게 확인할수있습니까?	배송문의
당일배송 도착시간 어떻게 확인할수있어요?	배송문의
당일배송제품 도착시간 어떻게 확인해?	배송문의
당일배송제품 도착시간 어떻게 확인해요?	배송문의
당일배송제품 도착시간 어떻게 확인합니까?	배송문의
당일배송제품 도착시간 어떻게 확인하나요?	배송문의
당일배송제품 도착시간 어떻게 확인됩니까?	배송문의
당일배송제품 도착시간 어떻게 확인할수있나요?	배송문의
당일배송제품 도착시간 어떻게 확인해야하나요?	배송문의
당일배송제품 도착시간 어떻게 확인이 가능할까요?	배송문의
당일배송제품 도착시간 어떻게 확인할수있습니까?	배송문의
당일배송제품 도착시간 어떻게 확인할수있어요?	배송문의
배송 도착시간 언제인가요?	배송문의
배송도착 시간 언제인가요?	배송문의
배송 도착 시간 언제인가요?	배송문의
배송도착시간 언제인가요?	배송문의
배송도착시간 궁금해요	배송문의
배송 도착시간 궁금해요	배송문의
배송도착 시간 궁금해요	배송문의
배송 언제도착하나요?	배송문의
배송 언제도착해요?	배송문의
배송 언제도착	배송문의
당일배송 언제도착해요?	배송문의
당일 배송 언제도착해요?	배송문의
당일배송 언제 도착해요?	배송문의
당일 배송 언제 도착해요?	배송문의
당일배송 언제도착하는지 궁금해요	배송문의
당일 배송 언제도착하는지 궁금해요	배송문의
당일배송 언제 도착하는지 궁금해요	배송문의
당일 배송 언제 도착하는지 궁금해요	배송문의
당일배송 언제도착하는지 알려주세요	배송문의
당일 배송 언제도착하는지 알려주세요	배송문의
당일배송 언제 도착하는지 알려주세요	배송문의
당일 배송 언제 도착하는지 알려주세요	배송문의
당일배송 언제도착해요?	배송문의
당일 배송 언제도착해요?	배송문의
당일배송 언제 도착해요?	배송문의
당일 배송 언제 도착해요?	배송문의
당일배송제품 언제도착해요?	배송문의
당일 배송제품 언제도착해요?	배송문의
당일배송 제품 언제도착해요?	배송문의
당일 배송 제품 언제도착해요?	배송문의
당일배송제품 언제 도착해요?	배송문의
당일 배송제품 언제 도착해요?	배송문의
당일배송 제품 언제 도착해요?	배송문의
당일 배송 제품 언제 도착해요?	배송문의
당일배송제품 언제도착합니까?	배송문의
당일 배송제품 언제도착합니까?	배송문의
당일배송 제품 언제도착합니까?	배송문의
당일 배송 제품 언제도착합니까?	배송문의
당일배송제품 언제 도착합니까?	배송문의
당일 배송제품 언제 도착합니까?	배송문의
당일배송 제품 언제 도착합니까?	배송문의
당일 배송 제품 언제 도착합니까?	배송문의
당일배송제품이 언제도착하는지 어떻게 확인할수있나요?	배송문의
당일 배송제품이 언제도착하는지 어떻게 확인할수있나요?	배송문의
당일배송 제품이 언제도착하는지 어떻게 확인할수있나요?	배송문의
당일 배송 제품이 언제도착하는지 어떻게 확인할수있나요?	배송문의
당일배송제품이 언제 도착하는지 어떻게 확인할수있나요?	배송문의
당일 배송제품이 언제 도착하는지 어떻게 확인할수있나요?	배송문의
당일배송 제품이 언제 도착하는지 어떻게 확인할수있나요?	배송문의
당일 배송 제품이 언제 도착하는지 어떻게 확인할수있나요?	배송문의
당일배송제품이 언제 도착하는지 어떻게 확인할 수 있나요?	배송문의
당일 배송제품이 언제 도착하는지 어떻게 확인할 수 있나요?	배송문의
당일배송 제품이 언제 도착하는지 어떻게 확인할 수 있나요?	배송문의
당일 배송 제품이 언제 도착하는지 어떻게 확인할 수 있나요?	배송문의
당일배송제품이 언제도착하는지 확인해주세요	배송문의
당일 배송제품이 언제도착하는지 확인해주세요	배송문의
당일배송 제품이 언제도착하는지 확인해주세요	배송문의
당일 배송 제품이 언제도착하는지 확인해주세요	배송문의
당일배송제품이 언제 도착하는지 확인해주세요	배송문의
당일 배송제품이 언제 도착하는지 확인해주세요	배송문의
당일배송 제품이 언제 도착하는지 확인해주세요	배송문의
당일 배송 제품이 언제 도착하는지 확인해주세요	배송문의
당일배송제품이 언제 도착하는지 확인 해주세요	배송문의
당일 배송제품이 언제 도착하는지 확인 해주세요	배송문의
당일배송 제품이 언제 도착하는지 확인 해주세요	배송문의
당일 배송 제품이 언제 도착하는지 확인 해주세요	배송문의
당일배송제품이 언제 도착하는지 확인해 주세요	배송문의
당일 배송제품이 언제 도착하는지 확인해 주세요	배송문의
당일배송 제품이 언제 도착하는지 확인해 주세요	배송문의
당일 배송 제품이 언제 도착하는지 확인해 주세요	배송문의
당일배송제품을 주문했습니다 몇시에 받아볼수있을까요?	배송문의
당일 배송제품을 주문했습니다 몇시에 받아볼수있을까요?	배송문의
당일배송 제품을 주문했습니다 몇시에 받아볼수있을까요?	배송문의
당일 배송 제품을 주문했습니다 몇시에 받아볼수있을까요?	배송문의
당일배송제품을 주문했습니다 몇 시에 받아볼수있을까요?	배송문의
당일 배송제품을 주문했습니다 몇 시에 받아볼수있을까요?	배송문의
당일배송 제품을 주문했습니다 몇 시에 받아볼수있을까요?	배송문의
당일 배송 제품을 주문했습니다 몇 시에 받아볼수있을까요?	배송문의
당일배송제품을 주문했습니다 몇 시에 받아볼 수 있을까요?	배송문의
당일 배송제품을 주문했습니다 몇 시에 받아볼 수 있을까요?	배송문의
당일배송 제품을 주문했습니다 몇 시에 받아볼 수 있을까요? 	배송문의
당일 배송 제품을 주문했습니다 몇 시에 받아볼 수 있을까요?	배송문의
당일배송도착시간은 어떻게 확인할수있나요?	배송문의
당일 배송도착시간은 어떻게 확인할수있나요?	배송문의
당일배송 도착시간은 어떻게 확인할수있나요?	배송문의
당일 배송 도착시간은 어떻게 확인할수있나요?	배송문의
당일배송도착시간은 어떻게 확인할 수 있나요?	배송문의
당일 배송도착시간은 어떻게 확인할 수 있나요?	배송문의
당일배송 도착시간은 어떻게 확인할 수 있나요?	배송문의
당일 배송 도착시간은 어떻게 확인할 수 있나요?	배송문의
당일배송제품의 도착시간 알수있나요?	배송문의
당일 배송제품의 도착시간 알수있나요?	배송문의
당일배송 제품의 도착시간 알수있나요?	배송문의
당일 배송 제품의 도착시간 알수있나요?	배송문의
당일배송제품의 도착시간 알 수 있나요?	배송문의
당일 배송제품의 도착시간 알 수 있나요?	배송문의
당일배송 제품의 도착시간 알 수 있나요?	배송문의
당일 배송 제품의 도착시간 알 수 있나요?	배송문의
당일배송제품의 도착시간 알고싶습니다	배송문의
당일 배송제품의 도착시간 알고싶습니다	배송문의
당일배송 제품의 도착시간 알고싶습니다	배송문의
당일 배송 제품의 도착시간 알고싶습니다	배송문의
당일배송제품의 도착시간 알고 싶습니다	배송문의
당일 배송제품의 도착시간 알고 싶습니다	배송문의
당일배송 제품의 도착시간 알고 싶습니다	배송문의
당일 배송 제품의 도착시간 알고 싶습니다	배송문의
당일배송제품 몇시에 도착합니까?	배송문의
당일 배송제품 몇시에 도착합니까?	배송문의
당일배송 제품 몇시에 도착합니까?	배송문의
당일 배송 제품 몇시에 도착합니까?	배송문의
당일배송제품 몇 시에 도착합니까?	배송문의
당일 배송제품 몇 시에 도착합니까?	배송문의
당일배송 제품 몇 시에 도착합니까?	배송문의
당일 배송 제품 몇 시에 도착합니까?	배송문의
당일배송제품 보통 언제도착하나요?	배송문의
당일 배송제품 보통 언제도착하나요?	배송문의
당일배송 제품 보통 언제도착하나요?	배송문의
당일 배송 제품 보통 언제도착하나요?	배송문의
당일배송제품 보통 언제 도착하나요?	배송문의
당일 배송제품 보통 언제 도착하나요?	배송문의
당일배송 제품 보통 언제 도착하나요?	배송문의
당일 배송 제품 보통 언제 도착하나요?	배송문의
당일배송은 언제도착하나요?	배송문의
당일 배송은 언제도착하나요?	배송문의
당일배송은 언제 도착하나요?	배송문의
당일 배송은 언제 도착하나요?	배송문의
당일배송은 언제도착합니까?	배송문의
당일 배송은 언제도착합니까?	배송문의
당일배송은 언제 도착합니까?	배송문의
당일 배송은 언제 도착합니까?	배송문의
당일배송은 보통 언제도착해요?	배송문의
당일 배송은 보통 언제도착해요?	배송문의
당일배송은 보통 언제 도착해요?	배송문의
당일 배송은 보통 언제 도착해요?	배송문의
당일배송제품의 도착시간이 궁금합니다	배송문의
당일 배송제품의 도착시간이 궁금합니다	배송문의
당일배송 제품의 도착시간이 궁금합니다	배송문의
당일 배송 제품의 도착시간이 궁금합니다	배송문의
당일배송제품 도착시간알려주세요	배송문의
당일 배송제품 도착시간알려주세요	배송문의
당일배송 제품 도착시간알려주세요	배송문의
당일 배송 제품 도착시간알려주세요	배송문의
당일배송제품 도착시간 알려주세요	배송문의
당일 배송제품 도착시간 알려주세요	배송문의
당일배송 제품 도착시간 알려주세요	배송문의
당일 배송 제품 도착시간 알려주세요	배송문의
당일배송상품 도착시간알려주세요	배송문의
당일 배송상품 도착시간알려주세요	배송문의
당일배송 상품 도착시간알려주세요	배송문의
당일 배송 상품 도착시간알려주세요	배송문의
당일배송상품 도착시간 알려주세요	배송문의
당일 배송상품 도착시간 알려주세요	배송문의
당일배송 상품 도착시간 알려주세요	배송문의
당일 배송 상품 도착시간 알려주세요	배송문의
당일배송도착시간 어떻게확인해?	배송문의
당일 배송도착시간 어떻게확인해?	배송문의
당일배송 도착시간 어떻게확인해?	배송문의
당일 배송 도착시간 어떻게확인해?	배송문의
당일배송도착시간 어떻게 확인해?	배송문의
당일 배송도착시간 어떻게 확인해?	배송문의
당일배송 도착시간 어떻게 확인해?	배송문의
당일 배송 도착시간 어떻게 확인해?	배송문의
당일배송도착시간 어떻게확인해요?	배송문의
당일 배송도착시간 어떻게확인해요?	배송문의
당일배송 도착시간 어떻게확인해요?	배송문의
당일 배송 도착시간 어떻게확인해요?	배송문의
당일배송도착시간 어떻게 확인해요?	배송문의
당일 배송도착시간 어떻게 확인해요?	배송문의
당일배송 도착시간 어떻게 확인해요?	배송문의
당일 배송 도착시간 어떻게 확인해요?	배송문의
당일배송도착시간 어떻게확인합니까?	배송문의
당일 배송도착시간 어떻게확인합니까?	배송문의
당일배송 도착시간 어떻게확인합니까?	배송문의
당일 배송 도착시간 어떻게확인합니까?	배송문의
당일배송도착시간 어떻게 확인합니까?	배송문의
당일 배송도착시간 어떻게 확인합니까?	배송문의
당일배송 도착시간 어떻게 확인합니까?	배송문의
당일 배송 도착시간 어떻게 확인합니까?	배송문의
당일배송도착시간 어떻게확인하나요?	배송문의
당일 배송도착시간 어떻게확인하나요?	배송문의
당일배송 도착시간 어떻게확인하나요?	배송문의
당일 배송 도착시간 어떻게확인하나요?	배송문의
당일배송도착시간 어떻게 확인하나요?	배송문의
당일 배송도착시간 어떻게 확인하나요?	배송문의
당일배송 도착시간 어떻게 확인하나요?	배송문의
당일 배송 도착시간 어떻게 확인하나요?	배송문의
당일배송도착시간 어떻게확인됩니까?	배송문의
당일 배송도착시간 어떻게확인됩니까?	배송문의
당일배송 도착시간 어떻게확인됩니까?	배송문의
당일 배송 도착시간 어떻게확인됩니까?	배송문의
당일배송도착시간 어떻게 확인됩니까?	배송문의
당일 배송도착시간 어떻게 확인됩니까?	배송문의
당일배송 도착시간 어떻게 확인됩니까?	배송문의
당일 배송 도착시간 어떻게 확인됩니까?	배송문의
당일배송도착시간 어떻게확인할수있나요?	배송문의
당일 배송도착시간 어떻게확인할수있나요?	배송문의
당일배송 도착시간 어떻게확인할수있나요?	배송문의
당일 배송 도착시간 어떻게확인할수있나요?	배송문의
당일배송도착시간 어떻게 확인할수있나요?	배송문의
당일 배송도착시간 어떻게 확인할수있나요?	배송문의
당일배송 도착시간 어떻게 확인할수있나요?	배송문의
당일 배송 도착시간 어떻게 확인할수있나요?	배송문의
당일배송도착시간 어떻게 확인할 수 있나요?	배송문의
당일 배송도착시간 어떻게 확인할 수 있나요?	배송문의
당일배송 도착시간 어떻게 확인할 수 있나요?	배송문의
당일 배송 도착시간 어떻게 확인할 수 있나요?	배송문의
당일배송도착시간 어떻게확인해야하나요?	배송문의
당일 배송도착시간 어떻게확인해야하나요?	배송문의
당일배송 도착시간 어떻게확인해야하나요?	배송문의
당일 배송 도착시간 어떻게확인해야하나요?	배송문의
당일배송도착시간 어떻게 확인해야하나요?	배송문의
당일 배송도착시간 어떻게 확인해야하나요?	배송문의
당일배송 도착시간 어떻게 확인해야하나요?	배송문의
당일 배송 도착시간 어떻게 확인해야하나요?	배송문의
당일배송도착시간 어떻게 확인이가능할까요?	배송문의
당일 배송도착시간 어떻게 확인이가능할까요?	배송문의
당일배송 도착시간 어떻게 확인이가능할까요?	배송문의
당일 배송 도착시간 어떻게 확인이가능할까요?	배송문의
당일배송도착시간 어떻게 확인이 가능할까요?	배송문의
당일 배송도착시간 어떻게 확인이 가능할까요?	배송문의
당일배송 도착시간 어떻게 확인이 가능할까요?	배송문의
당일 배송 도착시간 어떻게 확인이 가능할까요?	배송문의
당일배송도착시간 어떻게 확인이 가능할까요?	배송문의
당일배송도착시간 어떻게 확인할수있습니까?	배송문의
당일 배송도착시간 어떻게 확인할수있습니까?	배송문의
당일배송 도착시간 어떻게 확인할수있습니까?	배송문의
당일 배송 도착시간 어떻게 확인할수있습니까?	배송문의
당일배송도착시간 어떻게 확인할 수 있습니까?	배송문의
당일 배송도착시간 어떻게 확인할 수 있습니까?	배송문의
당일배송 도착시간 어떻게 확인할 수 있습니까?	배송문의
당일 배송 도착시간 어떻게 확인할 수 있습니까?	배송문의
당일배송도착시간 어떻게 확인할수있어요?	배송문의
당일 배송도착시간 어떻게 확인할수있어요?	배송문의
당일배송 도착시간 어떻게 확인할수있어요?	배송문의
당일 배송 도착시간 어떻게 확인할수있어요?	배송문의
당일배송도착시간 어떻게 확인 할 수있어요?	배송문의
당일 배송도착시간 어떻게 확인 할 수있어요?	배송문의
당일배송 도착시간 어떻게 확인 할 수있어요?	배송문의
당일 배송 도착시간 어떻게 확인 할 수있어요?	배송문의
당일배송제품도착시간 어떻게 확인해?	배송문의
당일 배송제품도착시간 어떻게 확인해?	배송문의
당일배송 제품도착시간 어떻게 확인해?	배송문의
당일배송제품 도착시간 어떻게 확인해?	배송문의
당일 배송 제품도착시간 어떻게 확인해?	배송문의
당일 배송제품 도착시간 어떻게 확인해?	배송문의
당일배송 제품 도착시간 어떻게 확인해?	배송문의
당일배송제품도착시간 어떻게 확인 해?	배송문의
당일 배송제품도착시간 어떻게 확인 해?	배송문의
당일배송 제품도착시간 어떻게 확인 해?	배송문의
당일배송제품 도착시간 어떻게 확인 해?	배송문의
당일 배송 제품도착시간 어떻게 확인 해?	배송문의
당일 배송제품 도착시간 어떻게 확인 해?	배송문의
당일배송 제품 도착시간 어떻게 확인 해?	배송문의
당일배송제품도착시간 어떻게확인해요?	배송문의
당일 배송제품도착시간 어떻게확인해요?	배송문의
당일배송 제품도착시간 어떻게확인해요?	배송문의
당일 배송 제품도착시간 어떻게확인해요?	배송문의
당일배송제품도착시간 어떻게 확인해요?	배송문의
당일 배송제품도착시간 어떻게 확인해요?	배송문의
당일배송 제품도착시간 어떻게 확인해요?	배송문의
당일 배송 제품도착시간 어떻게 확인해요?	배송문의
당일배송제품 도착시간 어떻게확인합니까?	배송문의
당일 배송제품 도착시간 어떻게확인합니까?	배송문의
당일배송 제품 도착시간 어떻게확인합니까?	배송문의
당일 배송 제품 도착시간 어떻게확인합니까?	배송문의
당일배송제품 도착시간 어떻게 확인합니까?	배송문의
당일 배송제품 도착시간 어떻게 확인합니까?	배송문의
당일배송 제품 도착시간 어떻게 확인합니까?	배송문의
당일 배송 제품 도착시간 어떻게 확인합니까?	배송문의
당일배송제품 도착시간 어떻게확인하나요?	배송문의
당일 배송제품 도착시간 어떻게확인하나요?	배송문의
당일배송 제품 도착시간 어떻게확인하나요?	배송문의
당일 배송 제품 도착시간 어떻게확인하나요?	배송문의
당일배송제품 도착시간 어떻게 확인하나요?	배송문의
당일 배송제품 도착시간 어떻게 확인하나요?	배송문의
당일배송 제품 도착시간 어떻게 확인하나요?	배송문의
당일 배송 제품 도착시간 어떻게 확인하나요?	배송문의
당일배송제품 도착시간 어떻게확인됩니까?	배송문의
당일 배송제품 도착시간 어떻게확인됩니까?	배송문의
당일배송 제품 도착시간 어떻게확인됩니까?	배송문의
당일 배송 제품 도착시간 어떻게확인됩니까?	배송문의
당일배송제품 도착시간 어떻게 확인됩니까?	배송문의
당일 배송제품 도착시간 어떻게 확인됩니까?	배송문의
당일배송 제품 도착시간 어떻게 확인됩니까?	배송문의
당일 배송 제품 도착시간 어떻게 확인됩니까?	배송문의
당일배송제품 도착시간 어떻게확인할수있나요?	배송문의
당일 배송제품 도착시간 어떻게확인할수있나요?	배송문의
당일배송 제품 도착시간 어떻게확인할수있나요?	배송문의
당일 배송 제품 도착시간 어떻게확인할수있나요?	배송문의
당일배송제품 도착시간 어떻게 확인할수있나요?	배송문의
당일 배송제품 도착시간 어떻게 확인할수있나요?	배송문의
당일배송 제품 도착시간 어떻게 확인할수있나요?	배송문의
당일 배송 제품 도착시간 어떻게 확인할수있나요?	배송문의
당일배송제품 도착시간 어떻게 확인할 수 있나요?	배송문의
당일 배송제품 도착시간 어떻게 확인할 수 있나요?	배송문의
당일배송 제품 도착시간 어떻게 확인할 수 있나요?	배송문의
당일 배송 제품 도착시간 어떻게 확인할 수 있나요?	배송문의
당일배송제품 도착시간 어떻게확인해야하나요?	배송문의
당일 배송제품 도착시간 어떻게확인해야하나요?	배송문의
당일배송 제품 도착시간 어떻게확인해야하나요?	배송문의
당일 배송 제품 도착시간 어떻게확인해야하나요?	배송문의
당일배송제품 도착시간 어떻게 확인해야하나요?	배송문의
당일 배송제품 도착시간 어떻게 확인해야하나요?	배송문의
당일배송 제품 도착시간 어떻게 확인해야하나요?	배송문의
당일 배송 제품 도착시간 어떻게 확인해야하나요?	배송문의
당일배송제품 도착시간 어떻게 확인해야 하나요?	배송문의
당일 배송제품 도착시간 어떻게 확인해야 하나요?	배송문의
당일배송 제품 도착시간 어떻게 확인해야 하나요?	배송문의
당일 배송 제품 도착시간 어떻게 확인해야 하나요?	배송문의
당일배송제품 도착시간 어떻게확인이가능할까요?	배송문의
당일 배송제품 도착시간 어떻게확인이가능할까요?	배송문의
당일배송 제품 도착시간 어떻게확인이가능할까요?	배송문의
당일 배송 제품 도착시간 어떻게확인이가능할까요?	배송문의
당일배송제품 도착시간 어떻게 확인이가능할까요?	배송문의
당일 배송제품 도착시간 어떻게 확인이가능할까요?	배송문의
당일배송 제품 도착시간 어떻게 확인이가능할까요?	배송문의
당일 배송 제품 도착시간 어떻게 확인이가능할까요?	배송문의
당일배송제품 도착시간 어떻게 확인이 가능할까요?	배송문의
당일 배송제품 도착시간 어떻게 확인이 가능할까요?	배송문의
당일배송 제품 도착시간 어떻게 확인이 가능할까요?	배송문의
당일 배송 제품 도착시간 어떻게 확인이 가능할까요?	배송문의
당일배송제품 도착시간 어떻게확인할수있습니까?	배송문의
당일 배송제품 도착시간 어떻게확인할수있습니까?	배송문의
당일배송 제품 도착시간 어떻게확인할수있습니까?	배송문의
당일 배송 제품 도착시간 어떻게확인할수있습니까?	배송문의
당일배송제품 도착시간 어떻게 확인할수있습니까?	배송문의
당일 배송제품 도착시간 어떻게 확인할수있습니까?	배송문의
당일배송 제품 도착시간 어떻게 확인할수있습니까?	배송문의
당일 배송 제품 도착시간 어떻게 확인할수있습니까?	배송문의
당일배송제품 도착시간 어떻게 확인할 수 있습니까?	배송문의
당일 배송제품 도착시간 어떻게 확인할 수 있습니까?	배송문의
당일배송 제품 도착시간 어떻게 확인할 수 있습니까?	배송문의
당일 배송 제품 도착시간 어떻게 확인할 수 있습니까?	배송문의
당일배송제품 도착시간 어떻게확인할수있어요?	배송문의
당일 배송제품 도착시간 어떻게확인할수있어요?	배송문의
당일배송 제품 도착시간 어떻게확인할수있어요?	배송문의
당일 배송 제품 도착시간 어떻게확인할수있어요?	배송문의
당일배송제품 도착시간 어떻게 확인할수있어요?	배송문의
당일 배송제품 도착시간 어떻게 확인할수있어요?	배송문의
당일배송 제품 도착시간 어떻게 확인할수있어요?	배송문의
당일 배송 제품 도착시간 어떻게 확인할수있어요?	배송문의
당일배송제품 도착시간 어떻게 확인할 수 있어요?	배송문의
당일 배송제품 도착시간 어떻게 확인할 수 있어요?	배송문의
당일배송 제품 도착시간 어떻게 확인할 수 있어요?	배송문의
당일 배송 제품 도착시간 어떻게 확인할 수 있어요?	배송문의
저희 샘플 이번 달 가능 수량 확인될까요?	샘플문의
이번 달 샘플 수량 확인해주세요	샘플문의
이번 달 샘플 수량이 어떻게 돼요?	샘플문의
이번 달 샘플 수량	샘플문의
이번 달 샘플은 몇 개인가요?	샘플문의
이번 달 샘플 수량 확인부탁드립니다	샘플문의
이번 달 저희 샘플 가능 수량 확인부탁드려요	샘플문의
이번 달 저희 샘플 수량 궁금합니다	샘플문의
이번달 샘플 수량 궁금해요	샘플문의
이번 달 샘플 수량 몇 개인가요?	샘플문의
이번 달 받을 수 있는 샘플 몇 개 인가요?	샘플문의
이번달 샘플 수량 확인 어떻게 할 수 있나요?	샘플문의
이번 달 샘플 수량 확인하고 싶은데요 어디에서 확인 가능할까요?	샘플문의
저희 이번 달 샘플 수량 확인해주세요	샘플문의
저희 매장 이번 달 샘플 수량 확인부탁드립니다	샘플문의
샘플 수량 확인해주세요	샘플문의
이번 달 수령 가능한 샘플 수량 몇 개인가요?	샘플문의
이번 달 샘플 몇 개나 받을 수 있나요?	샘플문의
이번 달 샘플 몇 개나 받을 수 있습니까?	샘플문의
이번 달 수령 가능한 샘플 수량 확인해주세요	샘플문의
저희 매장에서 받을 수 있는 샘플 수량 알려주세요	샘플문의
저희 안경원에서 받을 수 있는 샘플 수량 확인해주세요	샘플문의
저희 매장에서 받을 수 있는 샘플 수량 확인해주세요	샘플문의
샘플 몇 개 받을 수 있는지 확인해주세요	샘플문의
저희 샘플 몇 개 받을 수 있는지 확인해주세요	샘플문의
저희 매장 샘플 몇 개 받을 수 있는지 확인해주세요	샘플문의
저희 안경원 샘플 몇 개 받을 수 있는지 확인해주세요	샘플문의
이번 달 샘플이 몇 개인가요?	샘플문의
이번 달 샘플 몇 개야?	샘플문의
이번 달 샘플 몇 개입니까?	샘플문의
이번 달 샘플 개수 어디서 확인해?	샘플문의
이번 달 샘플 개수 어디서 확인해요?	샘플문의
이번 달 샘플개수 어디서 확인하죠?	샘플문의
이번 달 샘플개수 어디서 확인할까요?	샘플문의
이번 달 샘플개수 어디서 확인할 수 있죠?	샘플문의
이번 달 샘플개수 어디서 확인할 수 있습니까?	샘플문의
이번 달 샘플 갯수 어디서 확인해?	샘플문의
이번 달 샘플 갯수 어디서 확인해요?	샘플문의
이번 달 샘플 갯수 어디서 확인하죠?	샘플문의
이번 달 샘플 갯수 어디서 확인할까요?	샘플문의
이번 달 샘플 갯수 어디서 확인할 수 있죠?	샘플문의
이번 달 샘플 갯수 어디서 확인할 수 있습니까?	샘플문의
저희 샘플 이번달 가능수량 확인될까요?	샘플문의
이번달 샘플수량 확인해주세요	샘플문의
이번달 샘플수량이 어떻게돼요?	샘플문의
이번달 샘플수량	샘플문의
이번달 샘플은 몇개인가요?	샘플문의
이번달 샘플수량 확인부탁드립니다	샘플문의
이번달 저희 샘플 가능수량 확인부탁드려요	샘플문의
이번달 저희 샘플수량 궁금합니다	샘플문의
이번달 샘플수량 궁금해요	샘플문의
이번달 샘플수량 몇개인가요?	샘플문의
이번달 받을수있는 샘플 몇개 인가요?	샘플문의
이번달 샘플수량확인 어떻게 할수있나요?	샘플문의
이번달 샘플수량확인하고 싶은데요 어디에서 확인 가능할까요?	샘플문의
저희 이번달 샘플수량확인해주세요	샘플문의
저희 매장 이번달 샘플수량확인부탁드립니다	샘플문의
샘플수량확인해주세요	샘플문의
이번달 수령 가능한 샘플 수량 몇개인가요?	샘플문의
이번달 샘플 몇개나 받을 수 있나요?	샘플문의
이번달 샘플 몇개나 받을 수 있습니까?	샘플문의
이번달 수령 가능한 샘플수량확인해주세요	샘플문의
저희 매장에서 받을수있는 샘플수량 알려주세요	샘플문의
저희 안경원에서 받을수있는 샘플수량 확인해주세요	샘플문의
저희 매장에서 받을수있는 샘플수량 확인해주세요	샘플문의
샘플 몇개 받을수있는지 확인해주세요	샘플문의
저희 샘플 몇개 받을수있는지 확인해주세요	샘플문의
저희 매장 샘플 몇개 받을수있는지 확인해주세요	샘플문의
저희 안경원 샘플 몇개 받을수있는지 확인해주세요	샘플문의
이번달 샘플이 몇개인가요?	샘플문의
이번달 샘플 몇개야?	샘플문의
이번달 샘플 몇개입니까?	샘플문의
이번달 샘플개수 어디서 확인해?	샘플문의
이번달 샘플개수 어디서 확인해요?	샘플문의
이번달 샘플개수 어디서 확인하죠?	샘플문의
이번달 샘플개수 어디서 확인할까요?	샘플문의
이번달 샘플개수 어디서 확인할수있죠?	샘플문의
이번달 샘플개수 어디서 확인할수있습니까?	샘플문의
이번달 샘플개수 어디서 확인해?	샘플문의
이번달 샘플개수 어디서 확인해요?	샘플문의
이번달 샘플개수 어디서 확인하죠?	샘플문의
이번달 샘플개수 어디서 확인할까요?	샘플문의
이번달 샘플개수 어디서 확인할수있죠?	샘플문의
이번달 샘플개수 어디서 확인할수있습니까?	샘플문의
이번달 샘플갯수 어디서 확인해?	샘플문의
이번달 샘플갯수 어디서 확인해요?	샘플문의
이번달 샘플갯수 어디서 확인하죠?	샘플문의
이번달 샘플갯수 어디서 확인할까요?	샘플문의
이번달 샘플갯수 어디서 확인할수있죠?	샘플문의
이번달 샘플갯수 어디서 확인할수있습니까?	샘플문의
이번달 샘플갯수 어디서 확인해?	샘플문의
이번달 샘플갯수 어디서 확인해요?	샘플문의
이번달 샘플갯수 어디서 확인하죠?	샘플문의
이번달 샘플갯수 어디서 확인할까요?	샘플문의
이번달 샘플갯수 어디서 확인할수있죠?	샘플문의
이번달 샘플갯수 어디서 확인할수있습니까?	샘플문의
이번달 샘플 개수 어디서 확인해?	샘플문의
이번달 샘플 개수 어디서 확인해요?	샘플문의
이번달 샘플 개수 어디서 확인하죠?	샘플문의
이번달 샘플 개수 어디서 확인할까요?	샘플문의
이번달 샘플 개수 어디서 확인할수있죠?	샘플문의
이번달 샘플 개수 어디서 확인할수있습니까?	샘플문의
이번달 샘플 개수 어디서 확인해?	샘플문의
이번달 샘플 개수 어디서 확인해요?	샘플문의
이번달 샘플 개수 어디서 확인하죠?	샘플문의
이번달 샘플 개수 어디서 확인할까요?	샘플문의
이번달 샘플 개수 어디서 확인할수있죠?	샘플문의
이번달 샘플 개수 어디서 확인할수있습니까?	샘플문의
이번달 샘플 갯수 어디서 확인해?	샘플문의
이번달 샘플 갯수 어디서 확인해요?	샘플문의
이번달 샘플 갯수 어디서 확인하죠?	샘플문의
이번달 샘플 갯수 어디서 확인할까요?	샘플문의
이번달 샘플 갯수 어디서 확인할수있죠?	샘플문의
이번달 샘플 갯수 어디서 확인할수있습니까?	샘플문의
이번달 샘플 갯수 어디서 확인해?	샘플문의
이번달 샘플 갯수 어디서 확인해요?	샘플문의
이번달 샘플 갯수 어디서 확인하죠?	샘플문의
이번달 샘플 갯수 어디서 확인할까요?	샘플문의
이번달 샘플 갯수 어디서 확인할수있죠?	샘플문의
이번달 샘플 갯수 어디서 확인할수있습니까?	샘플문의
저희 샘플 이번 달 가능수량 확인될까요?	샘플문의
이번 달 샘플수량 확인해주세요	샘플문의
이번 달 샘플수량이 어떻게돼요?	샘플문의
이번 달 샘플수량	샘플문의
이번 달 샘플은 몇개인가요?	샘플문의
이번 달 샘플수량 확인부탁드립니다	샘플문의
이번 달 저희 샘플 가능수량 확인부탁드려요	샘플문의
이번 달 저희 샘플수량 궁금합니다	샘플문의
이번 달 샘플수량 궁금해요	샘플문의
이번 달 샘플수량 몇개인가요?	샘플문의
이번 달 받을수있는 샘플 몇개 인가요?	샘플문의
이번 달 샘플수량확인 어떻게 할수있나요?	샘플문의
이번 달 샘플수량확인하고 싶은데요 어디에서 확인 가능할까요?	샘플문의
저희 이번 달 샘플수량확인해주세요	샘플문의
저희 매장 이번 달 샘플수량확인부탁드립니다	샘플문의
샘플수량확인해주세요	샘플문의
이번 달 수령 가능한 샘플 수량 몇개인가요?	샘플문의
이번 달 샘플 몇개나 받을 수 있나요?	샘플문의
이번 달 샘플 몇개나 받을 수 있습니까?	샘플문의
이번 달 수령 가능한 샘플수량확인해주세요	샘플문의
저희 매장에서 받을수있는 샘플 수량 알려주세요	샘플문의
저희 안경원에서 받을수있는 샘플 수량 확인해주세요	샘플문의
저희 매장에서 받을수있는 샘플 수량 확인해주세요	샘플문의
샘플 몇 개 받을수있는지 확인해주세요	샘플문의
저희 샘플 몇 개 받을수있는지 확인해주세요	샘플문의
저희 매장 샘플 몇 개 받을수있는지 확인해주세요	샘플문의
저희 안경원 샘플 몇 개 받을수있는지 확인해주세요	샘플문의
이번 달 샘플이 몇개인가요?	샘플문의
이번 달 샘플 몇개야?	샘플문의
이번 달 샘플 몇개입니까?	샘플문의
이번 달 샘플개수 어디서 확인해?	샘플문의
이번 달 샘플개수 어디서 확인해요?	샘플문의
이번 달 샘플개수 어디서 확인하죠?	샘플문의
이번 달 샘플개수 어디서 확인할까요?	샘플문의
이번 달 샘플개수 어디서 확인할수있죠?	샘플문의
이번 달 샘플개수 어디서 확인할수있습니까?	샘플문의
이번 달 샘플개수 어디서 확인해?	샘플문의
이번 달 샘플개수 어디서 확인해요?	샘플문의
이번 달 샘플개수 어디서 확인하죠?	샘플문의
이번 달 샘플개수 어디서 확인할까요?	샘플문의
이번 달 샘플개수 어디서 확인할수있죠?	샘플문의
이번 달 샘플개수 어디서 확인할수있습니까?	샘플문의
이번 달 샘플갯수 어디서 확인해?	샘플문의
이번 달 샘플갯수 어디서 확인해요?	샘플문의
이번 달 샘플갯수 어디서 확인하죠?	샘플문의
이번 달 샘플갯수 어디서 확인할까요?	샘플문의
이번 달 샘플갯수 어디서 확인할수있죠?	샘플문의
이번 달 샘플갯수 어디서 확인할수있습니까?	샘플문의
이번 달 샘플갯수 어디서 확인해?	샘플문의
이번 달 샘플갯수 어디서 확인해요?	샘플문의
이번 달 샘플갯수 어디서 확인하죠?	샘플문의
이번 달 샘플갯수 어디서 확인할까요?	샘플문의
이번 달 샘플갯수 어디서 확인할수있죠?	샘플문의
이번 달 샘플갯수 어디서 확인할수있습니까?	샘플문의
이번 달 샘플 개수 어디서 확인해?	샘플문의
이번 달 샘플 개수 어디서 확인해요?	샘플문의
이번 달 샘플 개수 어디서 확인하죠?	샘플문의
이번 달 샘플 개수 어디서 확인할까요?	샘플문의
이번 달 샘플 개수 어디서 확인할수있죠?	샘플문의
이번 달 샘플 개수 어디서 확인할수있습니까?	샘플문의
이번 달 샘플 개수 어디서 확인해?	샘플문의
이번 달 샘플 개수 어디서 확인해요?	샘플문의
이번 달 샘플 개수 어디서 확인하죠?	샘플문의
이번 달 샘플 개수 어디서 확인할까요?	샘플문의
이번 달 샘플 개수 어디서 확인할수있죠?	샘플문의
이번 달 샘플 개수 어디서 확인할수있습니까?	샘플문의
이번 달 샘플 갯수 어디서 확인해?	샘플문의
이번 달 샘플 갯수 어디서 확인해요?	샘플문의
이번 달 샘플 갯수 어디서 확인하죠?	샘플문의
이번 달 샘플 갯수 어디서 확인할까요?	샘플문의
이번 달 샘플 갯수 어디서 확인할수있죠?	샘플문의
이번 달 샘플 갯수 어디서 확인할수있습니까?	샘플문의
이번 달 샘플 갯수 어디서 확인해?	샘플문의
이번 달 샘플 갯수 어디서 확인해요?	샘플문의
이번 달 샘플 갯수 어디서 확인하죠?	샘플문의
이번 달 샘플 갯수 어디서 확인할까요?	샘플문의
이번 달 샘플 갯수 어디서 확인할수있죠?	샘플문의
이번 달 샘플 갯수 어디서 확인할수있습니까?	샘플문의
저희 샘플 이번달 가능 수량 확인될까요?	샘플문의
이번달 샘플 수량 확인해주세요	샘플문의
이번달 샘플 수량이 어떻게돼요?	샘플문의
이번달 샘플 수량	샘플문의
이번달 샘플은 몇 개인가요?	샘플문의
이번달 샘플 수량 확인부탁드립니다	샘플문의
이번달 저희 샘플 가능 수량 확인부탁드려요	샘플문의
이번달 저희 샘플 수량 궁금합니다	샘플문의
이번달 샘플 수량 궁금해요	샘플문의
이번달 샘플 수량 몇개인가요?	샘플문의
이번달 받을 수 있는 샘플 몇개 인가요?	샘플문의
이번달 샘플 수량확인 어떻게 할수있나요?	샘플문의
이번달 샘플 수량 확인하고 싶은데요 어디에서 확인 가능할까요?	샘플문의
저희 이번달 샘플 수량 확인해주세요	샘플문의
저희 매장 이번달 샘플 수량 확인부탁드립니다	샘플문의
샘플 수량 확인해주세요	샘플문의
이번달 수령 가능한 샘플 수량 몇 개인가요?	샘플문의
이번달 샘플 몇 개나 받을 수 있나요?	샘플문의
이번달 샘플 몇 개나 받을 수 있습니까?	샘플문의
이번달 수령 가능한 샘플 수량 확인해주세요	샘플문의
저희 매장에서 받을 수 있는 샘플수량 알려주세요	샘플문의
저희 안경원에서 받을 수 있는 샘플수량 확인해주세요	샘플문의
저희 매장에서 받을 수 있는 샘플수량 확인해주세요	샘플문의
샘플 몇개 받을 수 있는지 확인해주세요	샘플문의
저희 샘플 몇개 받을 수 있는지 확인해주세요	샘플문의
저희 매장 샘플 몇개 받을 수 있는지 확인해주세요	샘플문의
저희 안경원 샘플 몇개 받을 수 있는지 확인해주세요	샘플문의
이번달 샘플이 몇 개인가요?	샘플문의
이번달 샘플 몇 개야?	샘플문의
이번달 샘플 몇 개입니까?	샘플문의
이번달 샘플개수 어디서 확인 해?	샘플문의
이번달 샘플개수 어디서 확인 해요?	샘플문의
이번달 샘플개수 어디서 확인 하죠?	샘플문의
이번달 샘플개수 어디서 확인 할까요?	샘플문의
이번달 샘플개수 어디서 확인 할수있죠?	샘플문의
이번달 샘플개수 어디서 확인 할수있습니까?	샘플문의
이번달 샘플개수 어디서 확인 해?	샘플문의
이번달 샘플개수 어디서 확인 해요?	샘플문의
이번달 샘플개수 어디서 확인 하죠?	샘플문의
이번달 샘플개수 어디서 확인 할까요?	샘플문의
이번달 샘플개수 어디서 확인 할수있죠?	샘플문의
이번달 샘플개수 어디서 확인 할수있습니까?	샘플문의
이번달 샘플갯수 어디서 확인 해?	샘플문의
이번달 샘플갯수 어디서 확인 해요?	샘플문의
이번달 샘플갯수 어디서 확인 하죠?	샘플문의
이번달 샘플갯수 어디서 확인 할까요?	샘플문의
이번달 샘플갯수 어디서 확인 할수있죠?	샘플문의
이번달 샘플갯수 어디서 확인 할수있습니까?	샘플문의
이번달 샘플갯수 어디서 확인 해?	샘플문의
이번달 샘플갯수 어디서 확인 해요?	샘플문의
이번달 샘플갯수 어디서 확인 하죠?	샘플문의
이번달 샘플갯수 어디서 확인 할까요?	샘플문의
이번달 샘플갯수 어디서 확인 할수있죠?	샘플문의
이번달 샘플갯수 어디서 확인 할수있습니까?	샘플문의
이번달 샘플 개수 어디서 확인 해?	샘플문의
이번달 샘플 개수 어디서 확인 해요?	샘플문의
이번달 샘플 개수 어디서 확인 하죠?	샘플문의
이번달 샘플 개수 어디서 확인 할까요?	샘플문의
이번달 샘플 개수 어디서 확인 할수있죠?	샘플문의
이번달 샘플 개수 어디서 확인 할수있습니까?	샘플문의
이번달 샘플 개수 어디서 확인 해?	샘플문의
이번달 샘플 개수 어디서 확인 해요?	샘플문의
이번달 샘플 개수 어디서 확인 하죠?	샘플문의
이번달 샘플 개수 어디서 확인 할까요?	샘플문의
이번달 샘플 개수 어디서 확인 할수있죠?	샘플문의
이번달 샘플 개수 어디서 확인 할수있습니까?	샘플문의
이번달 샘플 갯수 어디서 확인 해?	샘플문의
이번달 샘플 갯수 어디서 확인 해요?	샘플문의
이번달 샘플 갯수 어디서 확인 하죠?	샘플문의
이번달 샘플 갯수 어디서 확인 할까요?	샘플문의
이번달 샘플 갯수 어디서 확인 할수있죠?	샘플문의
이번달 샘플 갯수 어디서 확인 할수있습니까?	샘플문의
이번달 샘플 갯수 어디서 확인 해?	샘플문의
이번달 샘플 갯수 어디서 확인 해요?	샘플문의
이번달 샘플 갯수 어디서 확인 하죠?	샘플문의
이번달 샘플 갯수 어디서 확인 할까요?	샘플문의
이번달 샘플 갯수 어디서 확인 할수있죠?	샘플문의
이번달 샘플 갯수 어디서 확인 할수있습니까?	샘플문의
저희 샘플 이번 달 가능 수량 확인될까요?	샘플문의
이번 달 샘플 수량 확인해주세요	샘플문의
이번 달 샘플 수량이 어떻게돼요?	샘플문의
이번 달 샘플 수량	샘플문의
이번 달 샘플은 몇 개인가요?	샘플문의
이번 달 샘플 수량 확인부탁드립니다	샘플문의
이번 달 저희 샘플 가능 수량 확인부탁드려요	샘플문의
이번 달 저희 샘플 수량 궁금합니다	샘플문의
이번 달 샘플 수량 궁금해요	샘플문의
이번 달 샘플 수량 몇개인가요?	샘플문의
이번 달 받을 수 있는 샘플 몇개 인가요?	샘플문의
이번 달 샘플 수량확인 어떻게 할수있나요?	샘플문의
이번 달 샘플 수량 확인하고 싶은데요 어디에서 확인 가능할까요?	샘플문의
저희 이번 달 샘플 수량 확인해주세요	샘플문의
저희 매장 이번 달 샘플 수량 확인부탁드립니다	샘플문의
샘플 수량 확인해주세요	샘플문의
이번 달 수령 가능한 샘플 수량 몇 개인가요?	샘플문의
이번 달 샘플 몇 개나 받을 수 있나요?	샘플문의
이번 달 샘플 몇 개나 받을 수 있습니까?	샘플문의
이번 달 수령 가능한 샘플 수량 확인해주세요	샘플문의
저희 매장에서 받을 수 있는 샘플 수량 알려주세요	샘플문의
저희 안경원에서 받을 수 있는 샘플 수량 확인해주세요	샘플문의
저희 매장에서 받을 수 있는 샘플 수량 확인해주세요	샘플문의
샘플 몇 개 받을 수 있는지 확인해주세요	샘플문의
저희 샘플 몇 개 받을 수 있는지 확인해주세요	샘플문의
저희 매장 샘플 몇 개 받을 수 있는지 확인해주세요	샘플문의
저희 안경원 샘플 몇 개 받을 수 있는지 확인해주세요	샘플문의
이번 달 샘플이 몇 개인가요?	샘플문의
이번 달 샘플 몇 개야?	샘플문의
이번 달 샘플 몇 개입니까?	샘플문의
이번 달 샘플개수 어디서 확인 해?	샘플문의
이번 달 샘플개수 어디서 확인 해요?	샘플문의
이번 달 샘플개수 어디서 확인 하죠?	샘플문의
이번 달 샘플개수 어디서 확인 할까요?	샘플문의
이번 달 샘플개수 어디서 확인 할수있죠?	샘플문의
이번 달 샘플개수 어디서 확인 할수있습니까?	샘플문의
이번 달 샘플개수 어디서 확인 해?	샘플문의
이번 달 샘플개수 어디서 확인 해요?	샘플문의
이번 달 샘플개수 어디서 확인 하죠?	샘플문의
이번 달 샘플개수 어디서 확인 할까요?	샘플문의
이번 달 샘플개수 어디서 확인 할수있죠?	샘플문의
이번 달 샘플개수 어디서 확인 할수있습니까?	샘플문의
이번 달 샘플갯수 어디서 확인 해?	샘플문의
이번 달 샘플갯수 어디서 확인 해요?	샘플문의
이번 달 샘플갯수 어디서 확인 하죠?	샘플문의
이번 달 샘플갯수 어디서 확인 할까요?	샘플문의
이번 달 샘플갯수 어디서 확인 할수있죠?	샘플문의
이번 달 샘플갯수 어디서 확인 할수있습니까?	샘플문의
이번 달 샘플갯수 어디서 확인 해?	샘플문의
이번 달 샘플갯수 어디서 확인 해요?	샘플문의
이번 달 샘플갯수 어디서 확인 하죠?	샘플문의
이번 달 샘플갯수 어디서 확인 할까요?	샘플문의
이번 달 샘플갯수 어디서 확인 할수있죠?	샘플문의
이번 달 샘플갯수 어디서 확인 할수있습니까?	샘플문의
이번 달 샘플 개수 어디서 확인 해?	샘플문의
이번 달 샘플 개수 어디서 확인 해요?	샘플문의
이번 달 샘플 개수 어디서 확인 하죠?	샘플문의
이번 달 샘플 개수 어디서 확인 할까요?	샘플문의
이번 달 샘플 개수 어디서 확인 할수있죠?	샘플문의
이번 달 샘플 개수 어디서 확인 할수있습니까?	샘플문의
이번 달 샘플 개수 어디서 확인 해?	샘플문의
이번 달 샘플 개수 어디서 확인 해요?	샘플문의
이번 달 샘플 개수 어디서 확인 하죠?	샘플문의
이번 달 샘플 개수 어디서 확인 할까요?	샘플문의
이번 달 샘플 개수 어디서 확인 할수있죠?	샘플문의
이번 달 샘플 개수 어디서 확인 할수있습니까?	샘플문의
이번 달 샘플 갯수 어디서 확인 해?	샘플문의
이번 달 샘플 갯수 어디서 확인 해요?	샘플문의
이번 달 샘플 갯수 어디서 확인 하죠?	샘플문의
이번 달 샘플 갯수 어디서 확인 할까요?	샘플문의
이번 달 샘플 갯수 어디서 확인 할수있죠?	샘플문의
이번 달 샘플 갯수 어디서 확인 할수있습니까?	샘플문의
이번 달 샘플 갯수 어디서 확인 해?	샘플문의
이번 달 샘플 갯수 어디서 확인 해요?	샘플문의
이번 달 샘플 갯수 어디서 확인 하죠?	샘플문의
이번 달 샘플 갯수 어디서 확인 할까요?	샘플문의
이번 달 샘플 갯수 어디서 확인 할수있죠?	샘플문의
이번 달 샘플 갯수 어디서 확인 할수있습니까?	샘플문의
이번달 샘플 수량 확인 해주세요	샘플문의
이번 달 샘플 수량 확인 해주세요	샘플문의
이번달 샘플 수량이 어떻게 돼요?	샘플문의
이번 달 샘플 수량이 어떻게 돼요?	샘플문의
이번달 샘플 수량 확인 부탁드립니다	샘플문의
이번 달 샘플 수량 확인 부탁드립니다	샘플문의
이번달 저희 샘플 가능 수량 확인 부탁드려요	샘플문의
이번 달 저희 샘플 가능 수량 확인 부탁드려요	샘플문의
이번달 샘플 수량 몇 개인가요?	샘플문의
이번 달 샘플 수량 몇 개인가요?	샘플문의
이번달 받을 수 있는 샘플 몇 개 인가요?	샘플문의
이번 달 받을 수 있는 샘플 몇 개 인가요?	샘플문의
이번달 샘플 수량 확인 어떻게 할수있나요?	샘플문의
이번 달 샘플 수량 확인 어떻게 할수있나요?	샘플문의
이번달 샘플 수량 확인 어떻게 할 수 있나요?	샘플문의
이번 달 샘플 수량 확인 어떻게 할 수 있나요?	샘플문의
저희 이번달 샘플 수량 확인 해주세요	샘플문의
저희 이번 달 샘플 수량 확인 해주세요	샘플문의
저희 매장 이번달 샘플 수량 확인 부탁드립니다	샘플문의
저희 매장 이번 달 샘플 수량 확인 부탁드립니다	샘플문의
샘플 수량 확인 해주세요	샘플문의
샘플 수량 확인 해주세요	샘플문의
이번달 수령 가능한 샘플 수량 확인 해주세요	샘플문의
이번 달 수령 가능한 샘플 수량 확인 해주세요	샘플문의
저희 안경원에서 받을 수 있는 샘플수량 확인 해주세요	샘플문의
저희 안경원에서 받을 수 있는 샘플 수량 확인 해주세요	샘플문의
저희 매장에서 받을 수 있는 샘플수량 확인 해주세요	샘플문의
저희 매장에서 받을 수 있는 샘플 수량 확인 해주세요	샘플문의
샘플 몇개 받을 수 있는지 확인 해주세요	샘플문의
샘플 몇 개 받을 수 있는지 확인 해주세요	샘플문의
저희 샘플 몇개 받을 수 있는지 확인 해주세요	샘플문의
저희 샘플 몇 개 받을 수 있는지 확인 해주세요	샘플문의
저희 매장 샘플 몇개 받을 수 있는지 확인 해주세요	샘플문의
저희 매장 샘플 몇 개 받을 수 있는지 확인 해주세요	샘플문의
저희 안경원 샘플 몇개 받을 수 있는지 확인 해주세요	샘플문의
저희 안경원 샘플 몇 개 받을 수 있는지 확인 해주세요	샘플문의
이번달 샘플개수 어디서 확인 할 수 있죠?	샘플문의
이번 달 샘플개수 어디서 확인 할 수 있죠?	샘플문의
이번달 샘플개수 어디서 확인 할 수 있습니까?	샘플문의
이번 달 샘플개수 어디서 확인 할 수 있습니까?	샘플문의
이번달 샘플개수 어디서 확인 할 수 있죠?	샘플문의
이번 달 샘플개수 어디서 확인 할 수 있죠?	샘플문의
이번달 샘플개수 어디서 확인 할 수 있습니까?	샘플문의
이번 달 샘플개수 어디서 확인 할 수 있습니까?	샘플문의
이번달 샘플갯수 어디서 확인 할 수 있죠?	샘플문의
이번 달 샘플갯수 어디서 확인 할 수 있죠?	샘플문의
이번달 샘플갯수 어디서 확인 할 수 있습니까?	샘플문의
이번 달 샘플갯수 어디서 확인 할 수 있습니까?	샘플문의
이번달 샘플갯수 어디서 확인 할 수 있죠?	샘플문의
이번 달 샘플갯수 어디서 확인 할 수 있죠?	샘플문의
이번달 샘플갯수 어디서 확인 할 수 있습니까?	샘플문의
이번 달 샘플갯수 어디서 확인 할 수 있습니까?	샘플문의
이번달 샘플 개수 어디서 확인 할 수 있죠?	샘플문의
이번 달 샘플 개수 어디서 확인 할 수 있죠?	샘플문의
이번달 샘플 개수 어디서 확인 할 수 있습니까?	샘플문의
이번 달 샘플 개수 어디서 확인 할 수 있습니까?	샘플문의
이번달 샘플 개수 어디서 확인 할 수 있죠?	샘플문의
이번 달 샘플 개수 어디서 확인 할 수 있죠?	샘플문의
이번달 샘플 개수 어디서 확인 할 수 있습니까?	샘플문의
이번 달 샘플 개수 어디서 확인 할 수 있습니까?	샘플문의
이번달 샘플 갯수 어디서 확인 할 수 있죠?	샘플문의
이번 달 샘플 갯수 어디서 확인 할 수 있죠?	샘플문의
이번달 샘플 갯수 어디서 확인 할 수 있습니까?	샘플문의
이번 달 샘플 갯수 어디서 확인 할 수 있습니까?	샘플문의
이번달 샘플 갯수 어디서 확인 할 수 있죠?	샘플문의
이번 달 샘플 갯수 어디서 확인 할 수 있죠?	샘플문의
이번달 샘플 갯수 어디서 확인 할 수 있습니까?	샘플문의
이번 달 샘플 갯수 어디서 확인 할 수 있습니까?	샘플문의
샘플은 어떻게 신청이 가능한가요?	샘플문의
샘플 신청 방법 알려주세요	샘플문의
샘플 신청 방법	샘플문의
샘플 신청 방법을 알고 싶습니다	샘플문의
샘플 신청 어떻게 해야 돼요?	샘플문의
샘플 신청하고싶습니다 어떻게 해야할까요?	샘플문의
샘플 신청하려하는데 어떻게 하나요?	샘플문의
샘플 신청하는 법 알려주세요	샘플문의
샘플 신청 여기서 할 수 있나요?	샘플문의
샘플 신청합니다	샘플문의
샘플 신청하고싶어요	샘플문의
샘플 신청하는법 알려주세요	샘플문의
저희 매장에서 샘플을 받고싶은데 어디에서 신청할 수 있나요?	샘플문의
매장에서 샘플 받고싶어요 신청 어디로 해야할까요?	샘플문의
매장에서 샘플 받으려면 어떻게 신청해야할까요?	샘플문의
샘플 어디에서 신청할 수 있나요?	샘플문의
샘플 받고 싶습니다 따로 신청해야 합니까?	샘플문의
샘플 받으려면 신청해야하나요?	샘플문의
샘플 받으려면 어떻게 해야하죠?	샘플문의
샘플 받으려면 따로 신청해야하나요?	샘플문의
샘플 받고 싶습니다 신청하는 곳이 따로 있나요?	샘플문의
샘플 받고싶은데요 신청 어디서해요?	샘플문의
저희 매장으로 샘플 받고싶은데요 신청 어디서해요?	샘플문의
저희 안경원으로 샘플 받고싶은데요 신청 어디서해요?	샘플문의
저희 가게로 샘플 받고싶은데요 신청 어디서해요?	샘플문의
저희 매장으로 샘플 받아볼 수 있나요?	샘플문의
저희 안경원으로 샘플 받아볼 수 있나요?	샘플문의
저희 가게로 샘플 받아볼 수 있나요?	샘플문의
샘플 신청 어떻게 해야 되나요?	샘플문의
샘플 신청 어디서해?	샘플문의
샘플 신청 어디서해요?	샘플문의
샘플 신청 어디서합니까?	샘플문의
샘플 신청 어디서해야하죠?	샘플문의
샘플 신청 어디서해야합니까?	샘플문의
샘플 신청 어디서해야하는지 알려주세요	샘플문의
샘플 신청 어디로해?	샘플문의
샘플 신청 어디로해요?	샘플문의
샘플 신청 어디로해야하죠?	샘플문의
샘플 신청 어디로 해야하나요?	샘플문의
샘플 신청 어디로 해야할까요?	샘플문의
샘플 신청 어디로 해야할지 알려주세요	샘플문의
샘플 신청 어디로 해야하는지 알려줘	샘플문의
샘플 신청 어디로 할지 알려줘	샘플문의
샘플 신청 어디로 해야되는지 알려줘	샘플문의
샘플 신청 어디로 해야되는지 알려주세요	샘플문의
샘플 신청 어디로 해야되는지 알려주실수있나요	샘플문의
샘플은 어떻게 신청이 가능한가요?	샘플문의
샘플신청 방법알려주세요	샘플문의
샘플신청 방법	샘플문의
샘플신청 방법을 알고싶습니다	샘플문의
샘플신청 어떻게 해야돼요?	샘플문의
샘플신청하고싶습니다 어떻게 해야할까요?	샘플문의
샘플신청하려하는데 어떻게 하나요?	샘플문의
샘플신청하는법 알려주세요	샘플문의
샘플신청 여기서 할수있나요?	샘플문의
샘플신청합니다	샘플문의
샘플신청하고싶어요	샘플문의
샘플신청하는법 알려주세요	샘플문의
저희 매장에서 샘플을 받고싶은데 어디에서 신청할수있나요?	샘플문의
매장에서 샘플받고싶어요 신청어디로 해야할까요?	샘플문의
매장에서 샘플받으려면 어떻게 신청해야할까요?	샘플문의
샘플어디에서 신청할수있나요?	샘플문의
샘플받고싶습니다 따로 신청해야합니까?	샘플문의
샘플받으려면 신청해야하나요?	샘플문의
샘플받으려면 어떻게 해야하죠?	샘플문의
샘플받으려면 따로 신청해야하나요?	샘플문의
샘플받고싶습니다 신청하는곳이 따로 있나요?	샘플문의
샘플받고싶은데요 신청어디서해요?	샘플문의
저희 매장으로 샘플받고싶은데요 신청어디서해요?	샘플문의
저희 안경원으로 샘플받고싶은데요 신청어디서해요?	샘플문의
저희 가게로 샘플받고싶은데요 신청어디서해요?	샘플문의
저희 매장으로 샘플받아볼수있나요?	샘플문의
저희 안경원으로 샘플받아볼수있나요?	샘플문의
저희 가게로 샘플받아볼수있나요?	샘플문의
샘플신청 어떻게 해야 되나요?	샘플문의
샘플신청 어디서해?	샘플문의
샘플신청 어디서해요?	샘플문의
샘플신청 어디서합니까?	샘플문의
샘플신청 어디서해야하죠?	샘플문의
샘플신청 어디서해야합니까?	샘플문의
샘플신청 어디서해야하는지 알려주세요	샘플문의
샘플신청 어디로해?	샘플문의
샘플신청 어디로해요?	샘플문의
샘플신청 어디로해야하죠?	샘플문의
샘플신청 어디로해야하나요?	샘플문의
샘플신청 어디로해야할까요?	샘플문의
샘플신청 어디로해야할지 알려주세요	샘플문의
샘플신청 어디로해야하는지 알려줘	샘플문의
샘플신청 어디로할지 알려줘	샘플문의
샘플신청 어디로해야되는지 알려줘	샘플문의
샘플신청 어디로해야되는지 알려주세요	샘플문의
샘플신청 어디로해야되는지 알려주실수있나요	샘플문의
샘플 신청 방법알려주세요	샘플문의
샘플 신청 방법	샘플문의
샘플 신청 방법을 알고싶습니다	샘플문의
샘플 신청 어떻게 해야돼요?	샘플문의
샘플 신청하고싶습니다 어떻게 해야할까요?	샘플문의
샘플 신청하려하는데 어떻게 하나요?	샘플문의
샘플 신청하는법 알려주세요	샘플문의
샘플 신청 여기서 할수있나요?	샘플문의
샘플 신청합니다	샘플문의
샘플 신청하고싶어요	샘플문의
샘플 신청하는법 알려주세요	샘플문의
저희 매장에서 샘플을 받고싶은데 어디에서 신청할 수 있나요?	샘플문의
샘플 어디에서 신청할수있나요?	샘플문의
샘플 받고싶습니다 따로 신청해야합니까?	샘플문의
샘플 받으려면 신청해야하나요?	샘플문의
샘플 받으려면 어떻게 해야하죠?	샘플문의
샘플 받으려면 따로 신청해야하나요?	샘플문의
샘플 받고싶습니다 신청하는곳이 따로 있나요?	샘플문의
샘플 받고싶은데요 신청어디서해요?	샘플문의
저희 매장으로 샘플 받고싶은데요 신청어디서해요?	샘플문의
저희 안경원으로 샘플 받고싶은데요 신청어디서해요?	샘플문의
저희 가게로 샘플 받고싶은데요 신청어디서해요?	샘플문의
저희 매장으로 샘플 받아볼수있나요?	샘플문의
저희 안경원으로 샘플 받아볼수있나요?	샘플문의
저희 가게로 샘플 받아볼수있나요?	샘플문의
샘플 신청 어떻게 해야 되나요?	샘플문의
샘플 신청 어디서해?	샘플문의
샘플 신청 어디서해요?	샘플문의
샘플 신청 어디서합니까?	샘플문의
샘플 신청 어디서해야하죠?	샘플문의
샘플 신청 어디서해야합니까?	샘플문의
샘플 신청 어디서해야하는지 알려주세요	샘플문의
샘플 신청 어디로해?	샘플문의
샘플 신청 어디로해요?	샘플문의
샘플 신청 어디로해야하죠?	샘플문의
샘플 신청 어디로해야하나요?	샘플문의
샘플 신청 어디로해야할까요?	샘플문의
샘플 신청 어디로해야할지 알려주세요	샘플문의
샘플 신청 어디로해야하는지 알려줘	샘플문의
샘플 신청 어디로할지 알려줘	샘플문의
샘플 신청 어디로해야되는지 알려줘	샘플문의
샘플 신청 어디로해야되는지 알려주세요	샘플문의
샘플 신청 어디로해야되는지 알려주실수있나요	샘플문의
저희 매장으로 샘플받고싶은데요 신청 어디서해요?	샘플문의
저희 안경원으로 샘플받고싶은데요 신청 어디서해요?	샘플문의
저희 가게로 샘플받고싶은데요 신청 어디서해요?	샘플문의
저희 매장으로 샘플받아볼 수 있나요?	샘플문의
저희 안경원으로 샘플받아볼 수 있나요?	샘플문의
저희 가게로 샘플받아볼 수 있나요?	샘플문의
샘플신청 어떻게 해야 되나요?	샘플문의
샘플신청 어디서 해?	샘플문의
샘플신청 어디서 해요?	샘플문의
샘플신청 어디서 합니까?	샘플문의
샘플신청 어디서 해야하죠?	샘플문의
샘플신청 어디서 해야합니까?	샘플문의
샘플신청 어디서 해야하는지 알려주세요	샘플문의
샘플신청 어디로 해?	샘플문의
샘플신청 어디로 해요?	샘플문의
샘플신청 어디로 해야하죠?	샘플문의
샘플신청 어디로 해야하나요?	샘플문의
샘플신청 어디로 해야할까요?	샘플문의
샘플신청 어디로 해야할지 알려주세요	샘플문의
샘플신청 어디로 해야하는지 알려줘	샘플문의
샘플신청 어디로 할지 알려줘	샘플문의
샘플신청 어디로 해야되는지 알려줘	샘플문의
샘플신청 어디로 해야되는지 알려주세요	샘플문의
샘플신청 어디로 해야되는지 알려주실수있나요	샘플문의
샘플받고싶습니다 신청하는 곳이 따로 있나요?	샘플문의
샘플어디에서 신청할 수 있나요?	샘플문의
샘플신청 여기서 할 수 있나요?	샘플문의
샘플신청 방법 알려주세요	샘플문의
샘플 신청 방법 알려주세요	샘플문의
샘플 신청 여기서 할 수 있나요?	샘플문의
샘플 어디에서 신청할 수 있나요?	샘플문의
샘플 받고싶습니다 신청하는 곳이 따로 있나요?	샘플문의
저희 매장으로 샘플 받고싶은데요 신청 어디서해요?	샘플문의
저희 안경원으로 샘플 받고싶은데요 신청 어디서해요?	샘플문의
저희 가게로 샘플 받고싶은데요 신청 어디서해요?	샘플문의
저희 매장으로 샘플 받아볼 수 있나요?	샘플문의
저희 안경원으로 샘플 받아볼 수 있나요?	샘플문의
저희 가게로 샘플 받아볼 수 있나요?	샘플문의
샘플 신청 어떻게 해야 되나요?	샘플문의
샘플 신청 어디서 해?	샘플문의
샘플 신청 어디서 해요?	샘플문의
샘플 신청 어디서 합니까?	샘플문의
샘플 신청 어디서 해야하죠?	샘플문의
샘플 신청 어디서 해야합니까?	샘플문의
샘플 신청 어디서 해야하는지 알려주세요	샘플문의
샘플 신청 어디로 해?	샘플문의
샘플 신청 어디로 해요?	샘플문의
샘플 신청 어디로 해야하죠?	샘플문의
샘플 신청 어디로 해야하나요?	샘플문의
샘플 신청 어디로 해야할까요?	샘플문의
샘플 신청 어디로 해야할지 알려주세요	샘플문의
샘플 신청 어디로 해야하는지 알려줘	샘플문의
샘플 신청 어디로 할지 알려줘	샘플문의
샘플 신청 어디로 해야되는지 알려줘	샘플문의
샘플 신청 어디로 해야되는지 알려주세요	샘플문의
샘플 신청 어디로 해야되는지 알려주실수있나요	샘플문의
현재 판매되는 제품의 공급가와 소비자가 확인 가능할까요? 	제품가격
현재 판매되는 제품의 공급가와 소비자가 확인 가능할까요? 	제품가격
제품의 공급가와 소비자가 알 수 있나요?	제품가격
제품의 공급가와 소비자가 알 수 있을까요?	제품가격
제품의 공급가와 소비자가 알고 싶습니다	제품가격
제품의 공급가와 소비자가 알고 싶어요	제품가격
제품의 공급가와 소비자가 어떻게 확인 할 수 있나요?	제품가격
공금가와 소비자가를 확인하고 싶은데 어디에서 확인 할 수 있나요?	제품가격
공급자가와 소비자가를 어떻게 확인 할 수 있을까요?	제품가격
제품의 공급가와 소비자가 확인을 어디에서 할 수 있는지 알고싶습니다	제품가격
제품의 공급가와 소비자가를 확인할 수 있는 방법이 있나요?	제품가격
제품의 공급가와 소비자가를 어디에서 확인 할 수 있는지 궁금합니다	제품가격
제품의 공급가와 소비자가를 확인할 수 있는 방법이 있을까요?	제품가격
현재 판매중인 제품의 공급가와 소비자가를 확인 하고 싶습니다	제품가격
현재 판매중인 제품의 공급가와 소비자가를 어디에서 확인 할 수 있을까요?	제품가격
이 제품의 공급가와 소비자가를 확인하고싶습니다	제품가격
이 제품의 공급가와 소비자가를 확인할 방법이 있나요?	제품가격
현재 판매되는 제품의 공급가 확인 가능할까요?	제품가격
현재 판매되는 제품의 소비자가 확인 가능할까요?	제품가격
이 제품의 공급가가 얼마인가요?	제품가격
이 제품의 소비자가가 얼마인가요?	제품가격
이 제품의 공급가 확인 부탁드립니다	제품가격
이 제품의 소비자가 확인 부탁드립니다	제품가격
이 제품의 공급가가 궁금합니다	제품가격
이 제품의 소비자가가 궁금합니다	제품가격
이 상품의 공급자가 얼마에요?	제품가격
이 상품의 공급자가 얼마예요?	제품가격
상품의 공급자가 얼마에요?	제품가격
상품의 소비자가 얼마에요?	제품가격
이 상품의 소비자가 얼마에요?	제품가격
이 상품의 공급자가 얼마에요?	제품가격
이 제품의 소비자가 얼마에요?	제품가격
이 제품의 공급자가 얼마에요?	제품가격
제품의 공급가 알고 싶습니다.	제품가격
제품의 공급가와 소비자가 확인 어떻게 해?	제품가격
제품의 공급가와 소비자가 확인 어떻게 해요?	제품가격
제품의 공급가와 소비자가 확인 어떻게 하죠?	제품가격
제품의 공급가와 소비자가 확인 어떻게 하나요?	제품가격
제품의 공급가와 소비자가 확인 어떻게 합니까?	제품가격
제품의 공급가와 소비자가 확인 어떻게 할수있죠?	제품가격
제품의 공급가와 소비자가 확인 어떻게 해야하죠?	제품가격
제품의 공급가와 소비자가 확인 어떻게 해야되죠?	제품가격
제품의 공급가와 소비자가 확인 어떻게 해야돼죠?	제품가격
제품의 공급가와 소비자가 확인 어떻게 할수있나요?	제품가격
제품의 공급가와 소비자가 확인 어떻게 해야하나요?	제품가격
제품의 공급가와 소비자가 확인 어떻게 할수있습니까?	제품가격
제품의 공급가와 소비자가 확인 어떻게 할수있을까요?	제품가격
제품의 공급가와 소비자가 알수있나요?	제품가격
제품의 공급가와 소비자가 알수있을까요?	제품가격
제품의 공급가와 소비자가 알고싶습니다	제품가격
제품의 공급가와 소비자가 알고싶어요	제품가격
제품의 공급가와 소비자가 어떻게 확인할수있나요?	제품가격
공금가와 소비자가를 확인하고싶은데 어디에서 확인할수있나요?	제품가격
공급자가와 소비자가를 어떻게 확인 할수있을까요?	제품가격
제품의 공급가와 소비자가 확인을 어디에서 할수있는지 알고싶습니다	제품가격
제품의 공급가와 소비자가를 확인할수있은 방법이 있나요?	제품가격
제품의 공급가와 소비자가를 어디에서 확인 할수있는지 궁금합니다	제품가격
제품의 공급가와 소비자가를 확인할수있은 방법이 있을까요?	제품가격
현재 판매중인 제품의 공급가와 소비자가를 확인하고싶습니다	제품가격
현재 판매중인 제품의 공급가와 소비자가를 어디에서 확인할수있을까요?	제품가격
이 제품의 공급가와 소비자가를 확인할방법이있나요?	제품가격
현재 판매되는 제품의 공급가 확인가능할까요?	제품가격
현재 판매되는 제품의 소비자가 확인가능할까요?	제품가격
이제품의 공급가가 얼마인가요?	제품가격
이제품의 소비자가가 얼마인가요?	제품가격
이제품의 공급가 확인부탁드립니다	제품가격
이제품의 소비자가 확인부탁드립니다	제품가격
이제품의 공급가가 궁금합니다	제품가격
이제품의 소비자가가 궁금합니다	제품가격
이상품의 공급자가 얼마에요?	제품가격
이상품의 공급자가 얼마예요?	제품가격
상품의 공급자가 얼마예요?	제품가격
상품의 소비자가 얼마예요?	제품가격
이 상품의 소비자가 얼마예요?	제품가격
이 상품의 공급자가 얼마예요?	제품가격
이 제품의 소비자가 얼마예요?	제품가격
이 제품의 공급자가 얼마예요?	제품가격
제품의 공급가 알고싶습니다.	제품가격
제품의 공급가와 소비자가 확인 어떻게해?	제품가격
제품의 공급가와 소비자가 확인 어떻게해요?	제품가격
제품의 공급가와 소비자가 확인 어떻게하죠?	제품가격
제품의 공급가와 소비자가 확인 어떻게하나요?	제품가격
제품의 공급가와 소비자가 확인 어떻게합니까?	제품가격
제품의 공급가와 소비자가 확인 어떻게할수있죠?	제품가격
제품의 공급가와 소비자가 확인 어떻게해야하죠?	제품가격
제품의 공급가와 소비자가 확인 어떻게해야되죠?	제품가격
제품의 공급가와 소비자가 확인 어떻게해야돼죠?	제품가격
제품의 공급가와 소비자가 확인 어떻게할수있나요?	제품가격
제품의 공급가와 소비자가 확인 어떻게해야하나요?	제품가격
제품의 공급가와 소비자가 확인 어떻게할수있습니까?	제품가격
제품의 공급가와 소비자가 확인 어떻게할수있을까요?	제품가격
공금가와 소비자가를 확인하고싶은데 어디에서 확인할 수 있나요?	제품가격
제품의 공급가와 소비자가 확인 어떻게 할 수 있죠?	제품가격
제품의 공급가와 소비자가 확인 어떻게할 수 있죠?	제품가격
제품의 공급가와 소비자가 확인 어떻게 할 수 있나요?	제품가격
제품의 공급가와 소비자가 확인 어떻게할 수 있나요?	제품가격
제품의 공급가와 소비자가 확인 어떻게 할 수 있습니까?	제품가격
제품의 공급가와 소비자가 확인 어떻게할 수 있습니까?	제품가격
제품의 공급가와 소비자가 확인 어떻게 할 수 있을까요?	제품가격
제품의 공급가와 소비자가 확인 어떻게할 수 있을까요?	제품가격
제품 배송비 없이 주문하려면 얼마 이상 주문해야 하나요?	배송비
제품 배송비 없는 최소 주문 금액은 얼마인가요?	배송비
배송비 없이 주문하려면 얼마 이상 주문해야 하나요?	배송비
얼마 이상 주문해야 배송비 안 붙나요?	배송비
얼마 이상 주문해야 배송비 안 붙는지 궁금합니다	배송비
제품 배송비 없이 주문하려면 얼마 이상 주문해야 합니까?	배송비
배송비 없이 주문하려하는데 얼마 이상 주문해야할까요?	배송비
배송비없이 주문하고싶습니다 얼마이상 주문해야하나요?	배송비
얼마 이상 주문해야 배송비 없이 주문이 가능할까요?	배송비
얼마 이상 주문해야 배송비 없이 주문이 가능해요?	배송비
무료배송은 얼마부터인가요?	배송비
무료배송 조건 알려주세요	배송비
무료배송 조건 궁금합니다	배송비
어떻게 하면 배송비 없이 주문할 수 있을까요?	배송비
어떻게 하면 배송비 없이 주문할 수 있나요?	배송비
배송비 없이 주문하고싶습니다 어떻게 해야 할까요?	배송비
어떻게 하면 배송비 없이 주문할 수 있나요?	배송비
얼마 이상 구매해야 배송비가 안나올까요?	배송비
얼마 이상 주문해야 배송비가 안나올까요?	배송비
얼마 이상 주문해야 배송비가 안붙을까요?	배송비
얼마 이상 주문하면 배송비가 안붙나요?	배송비
얼마 이상 구매해야 배송비가 안붙나요?	배송비
배송비가 붙지않게 주문하려면 얼마나 주문해야하나요?	배송비
배송비 붙지않으려면 얼마나 주문해야합니까?	배송비
배송비없이 주문하고싶어요 얼마나 더 주문해야하나요?	배송비
얼마나 더 주문해야 배송비 없이 주문할 수 있을까요?	배송비
배송비가 안나오게 주문하려면 얼마나 주문해야하나요?	배송비
배송비가 나오지않게 주문하고싶습니다 얼마 이상 주문해야 가능할까요?	배송비
배송비가 없게 주문하려면 얼마 이상의 금액을 주문해야하나요?	배송비
배송비가 붇지않는 최소주문금액이 궁금합니다	배송비
제품 배송비가 붙지않는 최소주문금액이 궁금합니다	배송비
배송비 없이 주문하려면 얼마나 주문해야해요?	배송비
배송비 없이 주문하려면 얼마나 주문해야합니까?	배송비
배송비 없이 주문하고싶습니다 얼마나 주문해야하죠?	배송비
배송비 없이 주문하고싶어요 얼마나 주문해야될까요?	배송비
배송비 없이 주문하려면 얼마나 주문해야할까요?	배송비
배송비 없이 주문하려고합니다	배송비
배송비 없이 주문하고싶습니다	배송비
배송비 없이 주문하고싶어요	배송비
배송비 없는 주문금액 알려주세요	배송비
배송비 없는 주문금액 궁급합니다	배송비
배송비 없는 주문금액 알려주세요	배송비
배송비 없는 주문금액 얼마입니까?	배송비
제품배송비 없이 주문하려면 얼마나 주문해야해요?	배송비
제품배송비 없이 주문하려면 얼마나 주문해야합니까?	배송비
제품배송비 없이 주문하고싶습니다 얼마나 주문해야하죠?	배송비
제품배송비 없이 주문하고싶어요 얼마나 주문해야될까요?	배송비
제품배송비 없이 주문하려면 얼마나 주문해야할까요?	배송비
제품배송비 없이 주문하려고합니다	배송비
제품배송비 없이 주문하고싶습니다	배송비
제품배송비 없이 주문하고싶어요	배송비
제품배송비 없는 주문금액 알려주세요	배송비
제품배송비 없는 주문금액 궁급합니다	배송비
제품배송비 없는 주문금액 알려주세요	배송비
제품배송비 없는 주문금액 얼마입니까?	배송비
제품 배송비없는 최소주문금액은 얼마인가요?	배송비
제품 배송비없는 최소주문 금액은 얼마인가요?	배송비
제품 배송비없는 최소 주문금액은 얼마인가요?	배송비
배송비없이 주문하려면 얼마 이상 주문해야 하나요?	배송비
배송비 없이 주문하려면 얼마이상 주문해야 하나요?	배송비
배송비 없이 주문하려면 얼마 이상 주문해야하나요?	배송비
얼마이상 주문해야 배송비 안 붙나요?	배송비
얼마 이상 주문해야 배송비 안붙나요?	배송비
얼마 이상 주문해야 배송비안붙나요?	배송비
얼마이상 주문해야 배송비 안 붙는지 궁금합니다	배송비
얼마 이상 주문해야 배송비 안붙는지 궁금합니다	배송비
얼마이상주문해야 배송비 안붙는지 궁금합니다	배송비
제품 배송비없이 주문하려면 얼마 이상 주문해야 합니까?	배송비
제품 배송비 없이 주문하려면 얼마이상 주문해야 합니까?	배송비
제품 배송비 없이 주문하려면 얼마 이상 주문해야합니까?	배송비
제품 배송비없이 주문하려면 얼마이상 주문해야 합니까?	배송비
제품 배송비없이 주문하려면 얼마 이상 주문해야합니까?	배송비
배송비없이 주문하려하는데 얼마 이상 주문해야할까요?	배송비
배송비 없이 주문하려하는데 얼마이상 주문해야할까요?	배송비
배송비없이 주문하려하는데 얼마이상 주문해야할까요?	배송비
배송비없이 주문하려하는데 얼마이상 주문 해야할까요?	배송비
배송비 없이 주문하고싶습니다 얼마이상 주문해야하나요?	배송비
배송비없이 주문하고 싶습니다 얼마이상 주문해야하나요?	배송비
배송비없이 주문하고싶습니다 얼마 이상 주문해야하나요?	배송비
배송비없이 주문하고싶습니다 얼마이상 주문 해야하나요?	배송비
배송비없이 주문하고 싶습니다 얼마이상 주문해야하나요?	배송비
배송비 없이 주문하고싶습니다 얼마이상주문해야하나요?	배송비
배송비 없이 주문하고 싶습니다 얼마 이상 주문해야하나요?	배송비
얼마이상 주문해야 배송비 없이 주문이 가능할까요?	배송비
얼마 이상 주문해야 배송비없이 주문이 가능할까요?	배송비
얼마 이상 주문해야 배송비 없이 주문이가능할까요?	배송비
얼마이상 주문해야 배송비없이 주문이 가능할까요?	배송비
얼마이상 주문해야 배송비 없이 주문이가능할까요?	배송비
얼마이상 주문해야 배송비 없이 주문이 가능해요?	배송비
얼마 이상 주문해야 배송비없이 주문이 가능해요?	배송비
얼마 이상 주문해야 배송비 없이 주문이가능해요?	배송비
얼마이상 주문해야 배송비없이 주문이 가능해요?	배송비
얼마이상주문해야 배송비없이 주문이 가능해요?	배송비
무료배송은얼마부터인가요?	배송비
무료 배송은 얼마부터인가요?	배송비
무료 배송은 얼마부터 인가요?	배송비
무료배송조건 알려주세요	배송비
무료배송 조건알려주세요	배송비
무료 배송 조건 알려주세요	배송비
무료 배송 조건알려주세요	배송비
무료배송 조건궁금합니다	배송비
무료 배송 조건 궁금합니다	배송비
무료 배송 조건궁금합니다	배송비
어떻게하면 배송비 없이 주문할 수 있을까요?	배송비
어떻게 하면 배송비없이 주문할 수 있을까요?	배송비
어떻게 하면 배송비 없이 주문할수 있을까요?	배송비
어떻게하면 배송비없이 주문할 수 있을까요?	배송비
어떻게하면 배송비 없이 주문할수 있을까요?	배송비
어떻게하면 배송비 없이 주문할수있을까요?	배송비
어떻게하면 배송비없이 주문할수있을까요?	배송비
어떻게하면 배송비없이 주문할 수 있나요?	배송비
어떻게 하면 배송비없이 주문할수 있나요?	배송비
어떻게 하면 배송비 없이 주문할수있나요?	배송비
어떻게하면 배송비없이 주문할수있나요?	배송비
배송비없이 주문하고싶습니다 어떻게 해야 할까요?	배송비
배송비 없이 주문하고싶습니다 어떻게 해야할까요?	배송비
배송비없이 주문하고싶습니다 어떻게 해야할까요?	배송비
배송비없이 주문하고싶습니다 어떻게해야 할까요?	배송비
배송비없이 주문하고싶습니다 어떻게해야할까요?	배송비
배송비 없이 주문하고싶습니다 어떻게해야할까요?	배송비
어떻게하면 배송비 없이 주문할 수 있나요?	배송비
어떻게 하면 배송비없이 주문할 수 있나요?	배송비
어떻게 하면 배송비 없이 주문할수있나요?	배송비
어떻게하면 배송비없이 주문할 수 있나요?	배송비
어떻게하면 배송비 없이 주문할수있나요?	배송비
어떻게하면 배송비없이 주문할수있나요?	배송비
얼마이상 구매해야 배송비가 안나올까요?	배송비
얼마 이상 구매해야 배송비가안나올까요?	배송비
얼마이상 구매해야 배송비가안나올까요?	배송비
얼마이상구매해야 배송비가 안나올까요?	배송비
얼마이상구매해야 배송비가안나올까요?	배송비
얼마이상 주문해야 배송비가 안나올까요?	배송비
얼마이상주문해야 배송비가 안나올까요?	배송비
얼마이상 주문해야 배송비가 안붙을까요?	배송비
얼마 이상 주문해야 배송비가안붙을까요?	배송비
얼마이상 주문해야 배송비가안붙을까요?	배송비
얼마이상 주문하면 배송비가 안붙나요?	배송비
얼마 이상 주문하면 배송비가안붙나요?	배송비
얼마이상 주문하면 배송비가안붙나요?	배송비
얼마이상 구매해야 배송비가 안붙나요?	배송비
얼마 이상 구매해야 배송비가안붙나요?	배송비
얼마이상 구매해야 배송비가안붙나요?	배송비
얼마이상구매해야 배송비가안붙나요?	배송비
배송비가 붙지않게주문하려면 얼마나 주문해야하나요?	배송비
배송비가 붙지않게 주문하려면 얼마나주문해야하나요?	배송비
배송비가 붙지않게주문하려면 얼마나주문해야하나요?	배송비
배송비붙지않으려면 얼마나 주문해야합니까?	배송비
배송비 붙지않으려면 얼마나주문해야합니까?	배송비
배송비붙지않으려면 얼마나주문해야합니까?	배송비
배송비없이주문하고싶어요 얼마나 더 주문해야하나요?	배송비
배송비없이주문하고싶어요 얼마나더주문해야하나요?	배송비
배송비없이 주문하고싶어요 얼마나더주문해야하나요?	배송비
얼마나 더 주문해야 배송비없이 주문할 수 있을까요?	배송비
얼마나 더 주문해야 배송비 없이 주문할수있을까요?	배송비
얼마나 더 주문해야 배송비없이 주문할수있을까요?	배송비
배송비가 안나오게주문하려면 얼마나 주문해야하나요?	배송비
배송비가 안나오게 주문하려면 얼마나주문해야하나요?	배송비
배송비가 안나오게주문하려면 얼마나주문해야하나요?	배송비
배송비가 나오지않게 주문하고싶습니다 얼마이상 주문해야 가능할까요?	배송비
배송비가 나오지않게 주문하고싶습니다 얼마 이상 주문해야가능할까요?	배송비
배송비가 나오지않게 주문하고싶습니다 얼마이상 주문해야가능할까요?	배송비
배송비가나오지않게 주문하고싶습니다 얼마 이상 주문해야 가능할까요?	배송비
배송비가나오지않게 주문하고싶습니다 얼마이상주문해야 가능할까요?	배송비
배송비가나오지않게 주문하고싶습니다 얼마이상 주문해야 가능할까요?	배송비
배송비가없게 주문하려면 얼마 이상의 금액을 주문해야하나요?	배송비
배송비가 없게 주문하려면 얼마이상의 금액을 주문해야하나요?	배송비
배송비가 없게 주문하려면 얼마 이상의 금액을주문해야하나요?	배송비
배송비가없게 주문하려면 얼마이상의 금액을 주문해야하나요?	배송비
배송비가 붇지않는 최소 주문금액이 궁금합니다	배송비
배송비가 붇지않는 최소주문 금액이 궁금합니다	배송비
배송비가 붇지않는 최소 주문 금액이 궁금합니다	배송비
배송비가붇지않는 최소주문금액이 궁금합니다	배송비
배송비가붇지않는 최소 주문금액이 궁금합니다	배송비
배송비가붇지않는 최소주문 금액이 궁금합니다	배송비
배송비가붇지않는 최소 주문 금액이 궁금합니다	배송비
제품배송비가 붙지않는 최소주문금액이 궁금합니다	배송비
제품배송비가붙지않는 최소주문금액이 궁금합니다	배송비
제품 배송비가붙지않는 최소주문금액이 궁금합니다	배송비
제품 배송비가 붙지않는 최소 주문금액이 궁금합니다	배송비
제품 배송비가 붙지않는 최소주문 금액이 궁금합니다	배송비
제품 배송비가 붙지않는 최소 주문 금액이 궁금합니다	배송비
배송비없이 주문하려면 얼마나 주문해야해요?	배송비
배송비없이 주문하려면 얼마나주문해야해요?	배송비
배송비 없이 주문하려면 얼마나주문해야해요?	배송비
배송비없이주문하려면 얼마나 주문해야해요?	배송비
배송비없이 주문하려면 얼마나 주문해야합니까?	배송비
배송비 없이 주문하려면 얼마나주문해야합니까?	배송비
배송비없이 주문하려면 얼마나주문해야합니까?	배송비
배송비없이주문하려면 얼마나 주문해야합니까?	배송비
배송비없이주문하려면 얼마나주문해야합니까?	배송비
배송비없이 주문하고싶습니다 얼마나 주문해야하죠?	배송비
배송비없이 주문하고싶습니다 얼마나주문해야하죠?	배송비
배송비없이주문하고싶습니다 얼마나주문해야하죠?	배송비
배송비 없이 주문하고싶습니다 얼마나주문해야하죠?	배송비
배송비없이 주문하고싶어요 얼마나 주문해야될까요?	배송비
배송비 없이 주문하고싶어요 얼마나주문해야될까요?	배송비
배송비없이 주문하고싶어요 얼마나주문해야될까요?	배송비
배송비없이 주문하려면 얼마나 주문해야할까요?	배송비
배송비 없이 주문하려면 얼마나주문해야할까요?	배송비
배송비없이 주문하려면 얼마나주문해야할까요?	배송비
배송비없이주문하려면 얼마나주문해야할까요?	배송비
배송비없이 주문하려고합니다	배송비
배송비없이 주문하고싶습니다	배송비
배송비없이 주문하고싶어요	배송비
배송비없는 주문금액 알려주세요	배송비
배송비없는 주문금액 궁급합니다	배송비
배송비없는 주문금액 알려주세요	배송비
배송비없는 주문금액 얼마입니까?	배송비
제품배송비없이 주문하려면 얼마나 주문해야해요?	배송비
제품배송비 없이 주문하려면 얼마나주문해야해요?	배송비
제품배송비없이 주문하려면 얼마나주문해야해요?	배송비
제품배송비없이 주문하려면 얼마나 주문해야합니까?	배송비
제품배송비 없이 주문하려면 얼마나주문해야합니까?	배송비
제품배송비없이 주문하려면 얼마나주문해야합니까?	배송비
제품배송비없이 주문하고싶습니다 얼마나 주문해야하죠?	배송비
제품배송비 없이 주문하고싶습니다 얼마나주문해야하죠?	배송비
제품배송비없이 주문하고싶습니다 얼마나주문해야하죠?	배송비
제품배송비없이 주문하고싶어요 얼마나 주문해야될까요?	배송비
제품배송비 없이 주문하고싶어요 얼마나주문해야될까요?	배송비
제품배송비없이 주문하고싶어요 얼마나주문해야될까요?	배송비
제품배송비 없이 주문하려면 얼마나 주문해야할까요?	배송비
제품배송비 없이 주문하려면 얼마나 주문해야할까요?	배송비
제품배송비 없이 주문하려면 얼마나 주문해야할까요?	배송비
제품배송비없이 주문하려고합니다	배송비
제품배송비 없이 주문하려고 합니다	배송비
제품배송비없이 주문하려고 합니다	배송비
제품배송비없이 주문하고싶습니다	배송비
제품배송비 없이 주문하고 싶습니다	배송비
제품배송비없이 주문하고 싶습니다	배송비
제품배송비없이 주문하고싶어요	배송비
제품배송비 없이 주문하고 싶어요	배송비
제품배송비없이 주문하고 싶어요	배송비
제품배송비없는 주문금액 알려주세요	배송비
제품배송비 없는 주문금액알려주세요	배송비
제품배송비없는 주문금액알려주세요	배송비
제품배송비없는 주문 금액 알려주세요	배송비
제품배송비 없는 주문 금액알려주세요	배송비
제품배송비없는 주문 금액알려주세요	배송비
제품배송비없는 주문금액 궁급합니다	배송비
제품배송비 없는 주문금액궁급합니다	배송비
제품배송비없는 주문금액궁급합니다	배송비
제품배송비없는 주문 금액 궁급합니다	배송비
제품배송비 없는 주문 금액궁급합니다	배송비
제품배송비없는 주문 금액궁급합니다	배송비
제품배송비없는 주문금액 알려주세요	배송비
제품배송비 없는 주문금액알려주세요	배송비
제품배송비없는 주문금액알려주세요	배송비
제품배송비없는 주문 금액 알려주세요	배송비
제품배송비 없는 주문 금액알려주세요	배송비
제품배송비없는 주문 금액알려주세요	배송비
제품배송비없는 주문금액 얼마입니까?	배송비
제품배송비 없는 주문금액얼마입니까?	배송비
제품배송비없는 주문금액얼마입니까?	배송비
제품배송비없는 주문 금액 얼마입니까?	배송비
제품배송비 없는 주문 금액얼마입니까?	배송비
제품배송비없는 주문 금액얼마입니까?	배송비
